{
  "AllLayerTileDict": {
    "1": {
      "163": 1,
      "129": 1,
      "97": 1,
      "67": 1,
      "37": 1,
      "7": 1,
      "197": 1,
      "231": 1,
      "201": 1,
      "171": 1,
      "141": 1,
      "109": 1,
      "41": 1,
      "75": 1
    },
    "2": {
      "112": 1,
      "126": 1,
      "24": 1,
      "22": 1,
      "52": 1,
      "92": 1,
      "58": 1,
      "82": 1,
      "146": 1,
      "180": 1,
      "214": 1,
      "216": 1,
      "186": 1,
      "156": 1,
      "84": 1,
      "86": 1,
      "88": 1,
      "90": 1,
      "114": 1,
      "116": 1,
      "118": 1,
      "120": 1,
      "122": 1,
      "124": 1,
      "148": 1,
      "150": 1,
      "152": 1,
      "154": 1
    },
    "3": {
      "137": 1,
      "135": 1,
      "133": 1,
      "131": 1,
      "99": 1,
      "139": 1,
      "107": 1,
      "105": 1,
      "103": 1,
      "101": 1,
      "38": 1,
      "70": 1,
      "72": 1,
      "40": 1,
      "166": 1,
      "198": 1,
      "200": 1,
      "168": 1,
      "113": 1,
      "125": 1,
      "67": 1,
      "163": 1,
      "75": 1,
      "171": 1
    },
    "4": {
      "116": 1,
      "118": 1,
      "120": 1,
      "122": 1,
      "87": 1,
      "55": 1,
      "23": 1,
      "151": 1,
      "183": 1,
      "215": 1,
      "149": 1,
      "153": 1,
      "181": 1,
      "185": 1,
      "85": 1,
      "89": 1,
      "53": 1,
      "57": 1,
      "82": 1,
      "92": 1,
      "114": 1,
      "124": 1,
      "146": 1,
      "156": 1
    },
    "5": {
      "70": 1,
      "39": 1,
      "72": 1,
      "104": 1,
      "136": 1,
      "168": 1,
      "166": 1,
      "102": 1,
      "134": 1,
      "199": 1,
      "115": 1,
      "123": 1,
      "83": 1,
      "91": 1,
      "147": 1,
      "155": 1
    },
    "6": {
      "36": 1,
      "68": 1,
      "100": 1,
      "132": 1,
      "164": 1,
      "196": 1,
      "38": 1,
      "40": 1,
      "42": 1,
      "74": 1,
      "106": 1,
      "138": 1,
      "170": 1,
      "202": 1,
      "200": 1,
      "198": 1,
      "71": 1,
      "103": 1,
      "135": 1,
      "167": 1
    }
  },
  "TileItemArray": [],
  "TotalItemNum": 7,
  "MoveVect": [
    0.0,
    0.0
  ],
  "TileTotalNum": 0,
  "TileLevelHardType": "Hard",
  "TotalCount": 126
}