{
  "AllLayerTileDict": {
    "1": {
      "50": 1,
      "60": 1,
      "82": 1,
      "92": 1,
      "114": 1,
      "124": 1,
      "145": 1,
      "157": 1,
      "178": 1,
      "188": 1,
      "71": 1,
      "135": 1,
      "183": 1,
      "148": 1,
      "154": 1,
      "101": 1,
      "105": 1
    },
    "2": {
      "51": 1,
      "59": 1,
      "83": 1,
      "91": 1,
      "115": 1,
      "123": 1,
      "146": 1,
      "156": 1,
      "179": 1,
      "187": 1,
      "149": 1,
      "153": 1,
      "182": 1,
      "184": 1,
      "102": 1,
      "104": 1,
      "55": 1,
      "151": 1
    },
    "3": {
      "52": 1,
      "58": 1,
      "84": 1,
      "90": 1,
      "116": 1,
      "122": 1,
      "147": 1,
      "155": 1,
      "180": 1,
      "186": 1,
      "39": 1,
      "103": 1,
      "150": 1,
      "152": 1,
      "183": 1
    },
    "4": {
      "37": 1,
      "41": 1,
      "101": 1,
      "105": 1,
      "148": 1,
      "154": 1,
      "181": 1,
      "185": 1,
      "87": 1,
      "135": 1,
      "167": 1,
      "68": 1,
      "74": 1,
      "115": 1,
      "123": 1
    },
    "5": {
      "36": 1,
      "42": 1,
      "67": 1,
      "75": 1,
      "71": 1,
      "100": 1,
      "183": 1,
      "106": 1,
      "119": 1,
      "180": 1,
      "186": 1,
      "147": 1,
      "155": 1,
      "114": 1,
      "124": 1
    },
    "6": {
      "35": 1,
      "43": 1,
      "66": 1,
      "76": 1,
      "113": 1,
      "125": 1,
      "99": 1,
      "107": 1,
      "146": 1,
      "156": 1,
      "179": 1,
      "187": 1,
      "71": 1,
      "135": 1,
      "167": 1,
      "103": 1
    },
    "7": {
      "147": 1,
      "155": 1,
      "50": 1,
      "60": 1,
      "145": 1,
      "157": 1,
      "178": 1,
      "188": 1,
      "114": 1,
      "124": 1,
      "82": 1,
      "92": 1
    }
  },
  "TileItemArray": [
    2,
    3,
    5,
    7,
    8,
    9,
    10,
    12,
    13,
    14,
    16,
    15
  ],
  "TotalItemNum": 12,
  "MoveVect": [
    0.0,
    0.5
  ],
  "TileTotalNum": 0,
  "TileLevelHardType": "Normal",
  "TotalCount": 108
}