{
  "AllLayerTileDict": {
    "1": {
      "119": 1,
      "101": 1,
      "105": 1,
      "133": 1,
      "137": 1,
      "151": 1,
      "87": 1
    },
    "2": {
      "135": 1,
      "103": 1,
      "117": 1,
      "121": 1,
      "115": 1,
      "123": 1,
      "84": 1,
      "90": 1,
      "148": 1,
      "154": 1,
      "71": 1,
      "167": 1
    },
    "3": {
      "100": 1,
      "106": 1,
      "132": 1,
      "138": 1,
      "87": 1,
      "119": 1,
      "151": 1,
      "68": 1,
      "74": 1,
      "164": 1,
      "170": 1
    },
    "4": {
      "84": 1,
      "90": 1,
      "116": 1,
      "122": 1,
      "148": 1,
      "154": 1,
      "52": 1,
      "58": 1,
      "180": 1,
      "186": 1,
      "71": 1,
      "103": 1,
      "135": 1,
      "167": 1,
      "114": 1,
      "124": 1
    },
    "5": {
      "68": 1,
      "74": 1,
      "100": 1,
      "106": 1,
      "132": 1,
      "138": 1,
      "164": 1,
      "170": 1,
      "98": 1,
      "108": 1,
      "130": 1,
      "140": 1,
      "36": 1,
      "196": 1,
      "42": 1,
      "202": 1,
      "87": 1,
      "119": 1,
      "151": 1,
      "55": 1,
      "183": 1
    },
    "6": {
      "52": 1,
      "58": 1,
      "84": 1,
      "90": 1,
      "116": 1,
      "122": 1,
      "148": 1,
      "154": 1,
      "180": 1,
      "186": 1,
      "20": 1,
      "26": 1,
      "212": 1,
      "218": 1,
      "82": 1,
      "92": 1,
      "114": 1,
      "124": 1,
      "146": 1,
      "156": 1,
      "39": 1,
      "199": 1,
      "71": 1,
      "167": 1,
      "103": 1,
      "135": 1,
      "7": 1,
      "231": 1,
      "50": 1,
      "178": 1,
      "60": 1,
      "188": 1
    }
  },
  "TileItemArray": [],
  "TotalItemNum": 11,
  "MoveVect": [
    0.0,
    0.0
  ],
  "TileLevelHardType": "Normal",
  "TotalCount": 99
}