{
  "AllLayerTileDict": {
    "1": {
      "33": "1",
      "45": "1",
      "193": "1",
      "205": "1",
      "51": "1",
      "59": "1",
      "179": "1",
      "187": "1",
      "69": "1",
      "73": "1",
      "165": "1",
      "169": "1"
    },
    "2": {
      "49": "1",
      "61": "1",
      "177": "1",
      "189": "1",
      "35": "1",
      "43": "1",
      "195": "1",
      "203": "1",
      "85": "1",
      "89": "1",
      "149": "1",
      "153": "1"
    },
    "3": {
      "65": "1",
      "77": "1",
      "161": "1",
      "173": "1",
      "52": "1",
      "58": "1",
      "180": "1",
      "186": "1",
      "100": "1",
      "106": "1",
      "132": "1",
      "138": "1"
    },
    "4": {
      "81": "1",
      "93": "1",
      "145": "1",
      "157": "1",
      "68": "1",
      "74": "1",
      "164": "1",
      "170": "1",
      "99": "1",
      "107": "1",
      "131": "1",
      "139": "1"
    },
    "5": {
      "116": "1",
      "118": "1",
      "120": "1",
      "122": "1",
      "69": "1",
      "71": "1",
      "73": "1",
      "165": "1",
      "167": "1",
      "169": "1",
      "97": "1",
      "129": "1",
      "109": "1",
      "141": "1"
    },
    "6": {
      "113": "1",
      "125": "1",
      "70": "1",
      "72": "1",
      "117": "1",
      "119": "1",
      "121": "1",
      "166": "1",
      "168": "1"
    },
    "7": {
      "53": "1",
      "181": "1",
      "55": "1",
      "183": "1",
      "57": "1",
      "185": "1",
      "101": "1",
      "133": "1",
      "103": "1",
      "135": "1",
      "105": "1",
      "137": "1",
      "98": "1",
      "108": "1",
      "130": "1",
      "140": "1"
    },
    "8": {
      "99": "1",
      "107": "1",
      "131": "1",
      "139": "1",
      "85": "1",
      "149": "1",
      "87": "1",
      "151": "1",
      "89": "1",
      "153": "1",
      "37": "1",
      "197": "1",
      "39": "1",
      "199": "1",
      "41": "1",
      "201": "1",
      "118": "1",
      "120": "1"
    }
  },
  "TileItemArray": [],
  "TotalItemNum": 9,
  "MoveVect": [
    0.0,
    0.0
  ],
  "TileTotalNum": 0,
  "TileLevelHardType": "Normal",
  "TotalCount": 105
}