{
  "AllLayerTileDict": {
    "1": {
      "35": "1",
      "195": "1",
      "43": "1",
      "203": "1",
      "119": "1"
    },
    "2": {
      "51": "1",
      "179": "1",
      "59": "1",
      "187": "1",
      "102": "1",
      "104": "1",
      "136": "1",
      "134": "1"
    },
    "3": {
      "66": "1",
      "162": "1",
      "76": "1",
      "172": "1",
      "68": "1",
      "164": "1",
      "74": "1",
      "170": "1",
      "86": "1",
      "88": "1",
      "117": "1",
      "121": "1",
      "150": "1",
      "152": "1",
      "119": "1"
    },
    "4": {
      "85": "1",
      "149": "1",
      "83": "1",
      "147": "1",
      "89": "1",
      "153": "1",
      "91": "1",
      "155": "1",
      "87": "1",
      "151": "1",
      "81": "1",
      "93": "1",
      "145": "1",
      "157": "1",
      "120": "1",
      "118": "1"
    },
    "5": {
      "134": "1",
      "140": "1",
      "132": "1",
      "136": "1",
      "138": "1",
      "98": "1",
      "100": "1",
      "102": "1",
      "104": "1",
      "106": "1",
      "108": "1",
      "130": "1"
    },
    "6": {
      "97": "1",
      "109": "1",
      "86": "1",
      "150": "1",
      "88": "1",
      "152": "1",
      "84": "1",
      "148": "1",
      "90": "1",
      "154": "1",
      "118": "1",
      "116": "1",
      "120": "1",
      "122": "1",
      "129": "1",
      "141": "1"
    },
    "7": {
      "69": "1",
      "71": "1",
      "73": "1",
      "165": "1",
      "167": "1",
      "169": "1"
    },
    "8": {
      "53": "1",
      "55": "1",
      "57": "1",
      "181": "1",
      "183": "1",
      "185": "1"
    },
    "9": {
      "40": "1",
      "38": "1",
      "36": "1",
      "200": "1",
      "198": "1",
      "196": "1",
      "121": "1",
      "68": "1",
      "166": "1",
      "72": "1",
      "70": "1",
      "117": "1",
      "168": "1",
      "42": "1",
      "202": "1",
      "74": "1",
      "164": "1",
      "170": "1"
    }
  },
  "TileItemArray": [],
  "TotalItemNum": 10,
  "MoveVect": [
    0.0,
    0.0
  ],
  "TileTotalNum": 0,
  "TileLevelHardType": "Normal",
  "TotalCount": 102
}