{
  "AllLayerTileDict": {
    "1": {
      "34": "1",
      "194": "1",
      "44": "1",
      "204": "1",
      "66": "1",
      "162": "1",
      "76": "1",
      "172": "1",
      "36": "1",
      "42": "1",
      "196": "1",
      "202": "1",
      "68": "1",
      "74": "1",
      "164": "1",
      "170": "1"
    },
    "2": {
      "51": "1",
      "179": "1",
      "53": "1",
      "181": "1",
      "59": "1",
      "187": "1",
      "57": "1",
      "185": "1",
      "83": "1",
      "91": "1",
      "147": "1",
      "155": "1"
    },
    "3": {
      "68": "1",
      "164": "1",
      "100": "1",
      "132": "1",
      "70": "1",
      "166": "1",
      "72": "1",
      "168": "1",
      "74": "1",
      "170": "1",
      "106": "1",
      "138": "1",
      "98": "1",
      "108": "1",
      "130": "1",
      "140": "1"
    },
    "4": {
      "85": "1",
      "89": "1",
      "83": "1",
      "91": "1",
      "81": "1",
      "93": "1",
      "113": "1",
      "125": "1",
      "115": "1",
      "123": "1",
      "117": "1",
      "121": "1",
      "149": "1",
      "153": "1",
      "147": "1",
      "155": "1",
      "145": "1",
      "157": "1"
    },
    "5": {
      "98": "1",
      "108": "1",
      "130": "1",
      "140": "1",
      "132": "1",
      "138": "1",
      "150": "1",
      "88": "1",
      "152": "1",
      "86": "1",
      "100": "1",
      "106": "1",
      "118": "1",
      "120": "1"
    },
    "6": {
      "149": "1",
      "85": "1",
      "147": "1",
      "83": "1",
      "151": "1",
      "87": "1",
      "153": "1",
      "89": "1",
      "155": "1",
      "91": "1",
      "115": "1",
      "119": "1",
      "123": "1"
    },
    "7": {
      "66": "1",
      "68": "1",
      "70": "1",
      "72": "1",
      "74": "1",
      "76": "1",
      "108": "1",
      "140": "1",
      "172": "1",
      "170": "1",
      "168": "1",
      "166": "1",
      "164": "1",
      "162": "1",
      "130": "1",
      "98": "1",
      "100": "1",
      "102": "1",
      "104": "1",
      "106": "1",
      "138": "1",
      "136": "1",
      "134": "1",
      "132": "1"
    },
    "8": {
      "49": "1",
      "51": "1",
      "179": "1",
      "53": "1",
      "181": "1",
      "55": "1",
      "183": "1",
      "57": "1",
      "185": "1",
      "59": "1",
      "187": "1",
      "61": "1",
      "93": "1",
      "81": "1",
      "125": "1",
      "113": "1",
      "157": "1",
      "145": "1",
      "189": "1",
      "177": "1",
      "117": "1",
      "121": "1"
    }
  },
  "TileItemArray": [],
  "TotalItemNum": 12,
  "MoveVect": [
    0.0,
    0.0
  ],
  "TileTotalNum": 0,
  "TileLevelHardType": "Normal",
  "TotalCount": 135
}