{
  "AllLayerTileDict": {
    "1": {
      "185": "1",
      "181": "1",
      "57": "1",
      "121": "1",
      "87": "1",
      "53": "1",
      "157": "1",
      "125": "1_1",
      "93": "1",
      "189": "1_1",
      "209": "1",
      "61": "1_1",
      "29": "1",
      "17": "1",
      "49": "1_1",
      "81": "1",
      "113": "1_1",
      "145": "1",
      "177": "1_1",
      "117": "1",
      "221": "1",
      "151": "1"
    },
    "2": {
      "204": "1_1",
      "172": "1",
      "140": "1_1",
      "108": "1",
      "194": "1_1",
      "162": "1",
      "130": "1_1",
      "44": "1",
      "76": "1_1",
      "98": "1",
      "66": "1_1",
      "34": "1",
      "102": "1",
      "72": "1",
      "70": "1",
      "134": "1",
      "166": "1",
      "168": "1",
      "136": "1",
      "104": "1"
    },
    "3": {
      "187": "1",
      "155": "1",
      "123": "1",
      "91": "1",
      "59": "1",
      "179": "1",
      "147": "1",
      "115": "1",
      "83": "1",
      "51": "1",
      "119": "1",
      "151": "1",
      "87": "1"
    },
    "4": {
      "138": "1",
      "68": "1",
      "100": "1",
      "132": "1",
      "164": "1",
      "74": "1",
      "136": "1_1",
      "104": "1_1",
      "170": "1",
      "106": "1",
      "134": "1_1",
      "102": "1_1"
    },
    "5": {
      "119": "1",
      "85": "1",
      "89": "1",
      "149": "1",
      "153": "1"
    }
  },
  "TileItemArray": [
    2,
    12,
    4,
    13,
    7,
    10,
    15,
    6
  ],
  "TotalItemNum": 8,
  "MoveVect": [
    0.0,
    0.0
  ],
  "TileTotalNum": 0,
  "TileLevelHardType": "Hard",
  "TotalCount": 72
}