{
  "AllLayerTileDict": {
    "1": {
      "33": "1",
      "65": "1",
      "97": "1",
      "129": "1",
      "161": "1",
      "193": "1",
      "35": "1",
      "37": "1",
      "39": "1",
      "41": "1",
      "43": "1",
      "45": "1",
      "195": "1",
      "197": "1",
      "199": "1",
      "201": "1",
      "203": "1",
      "205": "1",
      "115": "1",
      "117": "1",
      "119": "1",
      "121": "1",
      "123": "1",
      "125": "1"
    },
    "2": {
      "50": "1",
      "82": "1",
      "114": "1",
      "146": "1",
      "178": "1",
      "180": "1",
      "182": "1",
      "184": "1",
      "186": "1",
      "188": "1",
      "52": "1",
      "54": "1",
      "56": "1",
      "58": "1",
      "60": "1",
      "108": "1",
      "140": "1",
      "100": "1",
      "102": "1",
      "104": "1",
      "106": "1",
      "132": "1",
      "134": "1",
      "136": "1",
      "138": "1"
    },
    "3": {
      "172": "1",
      "118": "1",
      "34": "1",
      "98": "1",
      "170": "1",
      "116": "1",
      "66": "1",
      "130": "1",
      "74": "1",
      "76": "1",
      "164": "1",
      "166": "1",
      "168": "1",
      "162": "1",
      "194": "1",
      "72": "1",
      "124": "1",
      "70": "1",
      "122": "1",
      "68": "1",
      "120": "1"
    },
    "4": {
      "35": "1",
      "67": "1",
      "99": "1",
      "131": "1",
      "163": "1",
      "195": "1",
      "53": "1",
      "181": "1",
      "55": "1",
      "183": "1",
      "57": "1",
      "185": "1",
      "59": "1",
      "187": "1",
      "61": "1",
      "189": "1",
      "101": "1",
      "103": "1",
      "105": "1",
      "107": "1",
      "109": "1",
      "133": "1",
      "135": "1",
      "137": "1",
      "139": "1",
      "141": "1"
    },
    "5": {
      "52": "1",
      "84": "1",
      "116": "1",
      "148": "1",
      "180": "1",
      "166": "1",
      "168": "1",
      "170": "1",
      "172": "1",
      "70": "1",
      "72": "1",
      "74": "1",
      "76": "1",
      "118": "1",
      "120": "1",
      "122": "1",
      "124": "1"
    },
    "6": {
      "51": "1",
      "53": "1",
      "55": "1",
      "57": "1",
      "59": "1",
      "61": "1",
      "93": "1",
      "125": "1",
      "157": "1",
      "189": "1",
      "187": "1",
      "185": "1",
      "183": "1",
      "181": "1",
      "179": "1",
      "147": "1",
      "115": "1",
      "83": "1",
      "101": "1",
      "103": "1",
      "105": "1",
      "107": "1",
      "133": "1",
      "135": "1",
      "137": "1",
      "139": "1"
    },
    "7": {
      "68": "1",
      "100": "1",
      "132": "1",
      "164": "1",
      "166": "1",
      "168": "1",
      "170": "1",
      "172": "1",
      "140": "1",
      "108": "1",
      "76": "1",
      "74": "1",
      "72": "1",
      "70": "1",
      "122": "1",
      "120": "1",
      "118": "1",
      "19": "1",
      "21": "1",
      "23": "1",
      "25": "1",
      "27": "1",
      "29": "1",
      "211": "1",
      "213": "1",
      "215": "1",
      "217": "1",
      "219": "1",
      "221": "1"
    }
  },
  "TileItemArray": [],
  "TotalItemNum": 12,
  "MoveVect": [
    0.0,
    0.0
  ],
  "TileTotalNum": 0,
  "TileLevelHardType": "Normal",
  "TotalCount": 168
}