{
  "AllLayerTileDict": {
    "1": {
      "214": "1",
      "216": "1",
      "17": "0",
      "77": "-1",
      "29": "-1",
      "65": "0"
    },
    "2": {
      "198": "1",
      "200": "1",
      "17": "0",
      "77": "-1",
      "29": "-1",
      "65": "0"
    },
    "3": {
      "184": "1",
      "182": "1",
      "17": "0",
      "77": "-1",
      "29": "-1",
      "65": "0"
    },
    "4": {
      "165": "1",
      "167": "1",
      "169": "1",
      "17": "0",
      "77": "-1",
      "29": "-1",
      "65": "0"
    },
    "5": {
      "149": "1",
      "151": "1",
      "153": "1",
      "17": "0",
      "77": "-1",
      "29": "-1",
      "65": "0"
    },
    "6": {
      "133": "1",
      "135": "1",
      "137": "1",
      "17": "0",
      "77": "-1",
      "29": "-1",
      "65": "0"
    },
    "7": {
      "77": "-1",
      "17": "0",
      "29": "-1",
      "65": "0"
    },
    "8": {
      "17": "0",
      "77": "-1",
      "120": "1",
      "118": "1",
      "29": "-1",
      "65": "0"
    },
    "9": {
      "134": "1",
      "103": "1",
      "136": "1",
      "17": "0",
      "77": "-1",
      "29": "-1",
      "65": "0"
    },
    "10": {
      "87": "1",
      "118": "1",
      "120": "1",
      "149": "1",
      "151": "1",
      "153": "1",
      "17": "0",
      "29": "-1"
    },
    "11": {
      "135": "1",
      "71": "1",
      "137": "1",
      "102": "1",
      "104": "1",
      "133": "1",
      "164": "1",
      "166": "1",
      "168": "1",
      "170": "1",
      "17": "0",
      "29": "-1"
    },
    "12": {
      "154": "1",
      "150": "1",
      "152": "1",
      "148": "1",
      "86": "1",
      "88": "1",
      "121": "1",
      "119": "1",
      "55": "1",
      "117": "1",
      "179": "1",
      "181": "1",
      "183": "1",
      "185": "1",
      "187": "1",
      "17": "0",
      "29": "-1"
    },
    "13": {
      "39": "1",
      "70": "1",
      "72": "1",
      "101": "1",
      "103": "1",
      "105": "1",
      "132": "1",
      "134": "1",
      "136": "1",
      "138": "1",
      "163": "1",
      "165": "1",
      "167": "1",
      "169": "1",
      "171": "1",
      "194": "1",
      "196": "1",
      "198": "1",
      "200": "1",
      "202": "1",
      "204": "1",
      "17": "0",
      "29": "-1"
    },
    "14": {
      "23": "1",
      "54": "1",
      "56": "1",
      "85": "1",
      "87": "1",
      "89": "1",
      "116": "1",
      "118": "1",
      "120": "1",
      "122": "1",
      "147": "1",
      "149": "1",
      "151": "1",
      "153": "1",
      "155": "1",
      "178": "1",
      "180": "1",
      "182": "1",
      "184": "1",
      "186": "1",
      "188": "1",
      "17": "0",
      "29": "-1"
    },
    "15": {
      "39": "1",
      "70": "1",
      "72": "1",
      "101": "1",
      "103": "1",
      "105": "1",
      "132": "1",
      "134": "1",
      "136": "1",
      "138": "1",
      "163": "1",
      "165": "1",
      "167": "1",
      "169": "1",
      "171": "1",
      "17": "0",
      "29": "-1"
    }
  },
  "TileItemArray": [],
  "TotalItemNum": 14,
  "MoveVect": [
    0.0,
    0.0
  ],
  "TileTotalNum": 0,
  "TileLevelHardType": "Normal",
  "TotalCount": 156
}