{
  "AllLayerTileDict": {
    "1": {
      "61": "1",
      "29": "1",
      "93": "1",
      "91": "1",
      "89": "1",
      "57": "1",
      "25": "1",
      "27": "1",
      "59": "1",
      "123": "1",
      "155": "1",
      "187": "1",
      "219": "1"
    },
    "2": {
      "28": "1",
      "60": "1",
      "92": "1",
      "90": "1",
      "88": "1",
      "56": "1",
      "24": "1",
      "26": "1",
      "58": "1",
      "122": "1",
      "154": "1",
      "186": "1",
      "218": "1"
    },
    "3": {
      "27": "1",
      "59": "1",
      "91": "1",
      "89": "1",
      "87": "1",
      "55": "1",
      "23": "1",
      "25": "1",
      "57": "1",
      "121": "1",
      "153": "1",
      "185": "1",
      "217": "1"
    },
    "4": {
      "26": "1",
      "58": "1",
      "90": "1",
      "88": "1",
      "86": "1",
      "54": "1",
      "22": "1",
      "24": "1",
      "56": "1",
      "120": "1",
      "152": "1",
      "184": "1",
      "216": "1"
    },
    "5": {
      "25": "1",
      "57": "1",
      "89": "1",
      "87": "1",
      "85": "1",
      "53": "1",
      "21": "1",
      "23": "1",
      "55": "1",
      "119": "1",
      "151": "1",
      "183": "1",
      "215": "1"
    },
    "6": {
      "24": "1",
      "56": "1",
      "88": "1",
      "86": "1",
      "84": "1",
      "52": "1",
      "20": "1",
      "22": "1",
      "54": "1",
      "118": "1",
      "150": "1",
      "182": "1",
      "214": "1"
    },
    "7": {
      "87": "1",
      "55": "1",
      "23": "1",
      "21": "1",
      "19": "1",
      "51": "1",
      "83": "1",
      "85": "1",
      "53": "1",
      "117": "1",
      "149": "1",
      "181": "1",
      "213": "1"
    },
    "8": {
      "22": "1",
      "54": "1",
      "86": "1",
      "84": "1",
      "82": "1",
      "50": "1",
      "18": "1",
      "20": "1",
      "52": "1",
      "116": "1",
      "148": "1",
      "180": "1",
      "212": "1"
    },
    "9": {
      "21": "1",
      "19": "1",
      "17": "1",
      "49": "1",
      "81": "1",
      "83": "1",
      "85": "1",
      "53": "1",
      "51": "1",
      "115": "1",
      "147": "1",
      "179": "1",
      "211": "1"
    }
  },
  "GoldTileCount": 0,
  "GasolineCount": 0,
  "TileItemArray": [],
  "TotalItemNum": 10,
  "MoveVect": [
    0.0,
    0.0
  ],
  "TileTotalNum": 0,
  "TileLevelHardType": "Normal",
  "TotalCount": 117
}