{
  "AllLayerTileDict": {
    "1": {
      "17": "1",
      "49": "1",
      "81": "1",
      "189": "1",
      "221": "1",
      "157": "1"
    },
    "2": {
      "34": "1",
      "66": "1",
      "98": "1",
      "204": "1",
      "172": "1",
      "140": "1"
    },
    "3": {
      "51": "1",
      "83": "1",
      "115": "1",
      "187": "1",
      "155": "1",
      "123": "1",
      "19": "1",
      "219": "1"
    },
    "4": {
      "68": "1",
      "100": "1",
      "132": "1",
      "170": "1",
      "138": "1",
      "106": "1",
      "66": "1",
      "98": "1",
      "130": "1",
      "108": "1",
      "140": "1",
      "172": "1",
      "36": "1",
      "202": "1"
    },
    "5": {
      "85": "1",
      "117": "1",
      "149": "1",
      "153": "1",
      "121": "1",
      "89": "1",
      "83": "1",
      "115": "1",
      "147": "1",
      "91": "1",
      "123": "1",
      "155": "1",
      "53": "1",
      "185": "1"
    },
    "6": {
      "102": "1",
      "134": "1",
      "166": "1",
      "136": "1",
      "104": "1",
      "72": "1",
      "90": "1",
      "122": "1",
      "154": "1",
      "168": "1",
      "70": "1",
      "84": "1",
      "116": "1",
      "148": "1"
    },
    "7": {
      "69": "1",
      "67": "1",
      "71": "1",
      "73": "1",
      "75": "1",
      "107": "1",
      "139": "1",
      "171": "1",
      "169": "1",
      "167": "1",
      "165": "1",
      "163": "1",
      "131": "1",
      "99": "1",
      "119": "1"
    },
    "8": {
      "50": "1",
      "52": "1",
      "180": "1",
      "54": "1",
      "182": "1",
      "56": "1",
      "184": "1",
      "58": "1",
      "186": "1",
      "60": "1",
      "92": "1",
      "82": "1",
      "124": "1",
      "114": "1",
      "156": "1",
      "146": "1",
      "188": "1",
      "178": "1",
      "102": "1",
      "104": "1",
      "136": "1",
      "134": "1",
      "154": "1",
      "90": "1",
      "84": "1",
      "148": "1"
    },
    "9": {
      "33": "1",
      "35": "1",
      "195": "1",
      "37": "1",
      "197": "1",
      "39": "1",
      "199": "1",
      "41": "1",
      "201": "1",
      "43": "1",
      "203": "1",
      "45": "1",
      "77": "1",
      "65": "1",
      "109": "1",
      "97": "1",
      "141": "1",
      "129": "1",
      "173": "1",
      "161": "1",
      "205": "1",
      "193": "1",
      "67": "1",
      "85": "1",
      "89": "1",
      "87": "1",
      "117": "1",
      "149": "1",
      "151": "1",
      "153": "1",
      "121": "1",
      "75": "1",
      "171": "1",
      "163": "1",
      "119": "1"
    }
  },
  "GoldTileCount": 0,
  "GasolineCount": 0,
  "TileItemArray": [],
  "TotalItemNum": 10,
  "MoveVect": [
    0.0,
    0.0
  ],
  "TileTotalNum": 0,
  "TileLevelHardType": "Hard",
  "TotalCount": 138
}