{
  "AllLayerTileDict": {
    "1": {
      "51": "1",
      "52": "1",
      "53": "1",
      "54": "1",
      "55": "1",
      "56": "1",
      "57": "1",
      "58": "1",
      "59": "1",
      "67": "1",
      "68": "1",
      "69": "1",
      "70": "1",
      "71": "1",
      "72": "1",
      "73": "1",
      "74": "1",
      "75": "1",
      "83": "1",
      "84": "1",
      "85": "1",
      "86": "1",
      "87": "1",
      "88": "1",
      "89": "1",
      "90": "1",
      "91": "1",
      "99": "1",
      "100": "1",
      "101": "1",
      "102": "1",
      "103": "1",
      "104": "1",
      "105": "1",
      "106": "1",
      "107": "1",
      "115": "1",
      "116": "1",
      "117": "1",
      "118": "1",
      "119": "1",
      "120": "1",
      "121": "1",
      "122": "1",
      "123": "1",
      "131": "1",
      "132": "1",
      "133": "1",
      "134": "1",
      "135": "1",
      "136": "1",
      "137": "1",
      "138": "1",
      "139": "1",
      "147": "1",
      "148": "1",
      "149": "1",
      "150": "1",
      "151": "1",
      "152": "1",
      "153": "1",
      "154": "1",
      "155": "1",
      "163": "1",
      "164": "1",
      "165": "1",
      "166": "1",
      "167": "1",
      "168": "1",
      "169": "1",
      "170": "1",
      "171": "1",
      "179": "1",
      "180": "1",
      "181": "1",
      "182": "1",
      "183": "1",
      "184": "1",
      "185": "1",
      "186": "1",
      "187": "1"
    },
    "2": {
      "71": "1",
      "86": "1",
      "87": "1",
      "88": "1",
      "101": "1",
      "102": "1",
      "103": "1",
      "104": "1",
      "105": "1",
      "116": "1",
      "117": "1",
      "118": "1",
      "119": "1",
      "120": "1",
      "121": "1",
      "122": "1",
      "133": "1",
      "134": "1",
      "135": "1",
      "136": "1",
      "137": "1",
      "150": "1",
      "151": "1",
      "152": "1",
      "167": "1"
    },
    "3": {
      "68": "1",
      "69": "1",
      "70": "1",
      "71": "1",
      "72": "1",
      "73": "1",
      "74": "1",
      "84": "1",
      "90": "1",
      "100": "1",
      "106": "1",
      "116": "1",
      "122": "1",
      "132": "1",
      "138": "1",
      "148": "1",
      "154": "1",
      "164": "1",
      "165": "1",
      "166": "1",
      "167": "1",
      "168": "1",
      "169": "1",
      "170": "1"
    },
    "4": {
      "103": "1",
      "118": "1",
      "119": "1",
      "120": "1",
      "135": "1"
    }
  },
  "GoldTileCount": 0,
  "GasolineCount": 0,
  "TileItemArray": [],
  "TotalItemNum": 12,
  "MoveVect": [
    0.0,
    0.0
  ],
  "TileTotalNum": 0,
  "TileLevelHardType": "Heroic",
  "TotalCount": 135
}