{
  "AllLayerTileDict": {
    "1": {
      "55": "1",
      "70": "1",
      "71": "1",
      "72": "1",
      "85": "1",
      "86": "1",
      "87": "1",
      "88": "1",
      "89": "1",
      "100": "1",
      "101": "1",
      "102": "1",
      "103": "1",
      "104": "1",
      "105": "1",
      "106": "1",
      "115": "1",
      "116": "1",
      "117": "1",
      "118": "1",
      "119": "1",
      "120": "1",
      "121": "1",
      "122": "1",
      "123": "1",
      "132": "1",
      "133": "1",
      "134": "1",
      "135": "1",
      "136": "1",
      "137": "1",
      "138": "1",
      "149": "1",
      "150": "1",
      "151": "1",
      "152": "1",
      "153": "1",
      "166": "1",
      "167": "1",
      "168": "1",
      "183": "1"
    },
    "2": {
      "71": "1",
      "86": "1",
      "87": "1",
      "88": "1",
      "101": "1",
      "102": "1",
      "103": "1",
      "104": "1",
      "105": "1",
      "116": "1",
      "117": "1",
      "118": "1",
      "119": "1",
      "120": "1",
      "121": "1",
      "122": "1",
      "133": "1",
      "134": "1",
      "135": "1",
      "136": "1",
      "137": "1",
      "150": "1",
      "151": "1",
      "152": "1",
      "167": "1"
    },
    "3": {
      "51": "1",
      "52": "1",
      "53": "1",
      "54": "1",
      "55": "1",
      "56": "1",
      "57": "1",
      "58": "1",
      "59": "1",
      "67": "1",
      "75": "1",
      "83": "1",
      "91": "1",
      "99": "1",
      "107": "1",
      "115": "1",
      "123": "1",
      "131": "1",
      "139": "1",
      "147": "1",
      "155": "1",
      "163": "1",
      "171": "1",
      "179": "1",
      "180": "1",
      "181": "1",
      "182": "1",
      "183": "1",
      "184": "1",
      "185": "1",
      "186": "1",
      "187": "1"
    },
    "4": {
      "87": "1",
      "102": "1",
      "103": "1",
      "104": "1",
      "117": "1",
      "118": "1",
      "119": "1",
      "120": "1",
      "121": "1",
      "134": "1",
      "135": "1",
      "136": "1",
      "151": "1"
    }
  },
  "GoldTileCount": 0,
  "GasolineCount": 0,
  "TileItemArray": [],
  "TotalItemNum": 10,
  "MoveVect": [
    0.0,
    0.0
  ],
  "TileTotalNum": 0,
  "TileLevelHardType": "Normal",
  "TotalCount": 111
}