{
  "AllLayerTileDict": {
    "1": {
      "39": "1",
      "54": "1",
      "55": "1",
      "56": "1",
      "69": "1",
      "70": "1",
      "71": "1",
      "72": "1",
      "73": "1",
      "84": "1",
      "85": "1",
      "86": "1",
      "87": "1",
      "88": "1",
      "89": "1",
      "90": "1",
      "99": "1",
      "100": "1",
      "101": "1",
      "102": "1",
      "103": "1",
      "104": "1",
      "105": "1",
      "106": "1",
      "107": "1",
      "114": "1",
      "115": "1",
      "116": "1",
      "117": "1",
      "118": "1",
      "119": "1",
      "120": "1",
      "121": "1",
      "122": "1",
      "123": "1",
      "124": "1",
      "131": "1",
      "132": "1",
      "133": "1",
      "134": "1",
      "135": "1",
      "136": "1",
      "137": "1",
      "138": "1",
      "139": "1",
      "148": "1",
      "149": "1",
      "150": "1",
      "151": "1",
      "152": "1",
      "153": "1",
      "154": "1",
      "165": "1",
      "166": "1",
      "167": "1",
      "168": "1",
      "169": "1",
      "182": "1",
      "183": "1",
      "184": "1",
      "199": "1"
    },
    "2": {
      "71": "1",
      "86": "1",
      "87": "1",
      "88": "1",
      "101": "1",
      "102": "1",
      "103": "1",
      "104": "1",
      "105": "1",
      "116": "1",
      "117": "1",
      "118": "1",
      "119": "1",
      "120": "1",
      "121": "1",
      "122": "1",
      "133": "1",
      "134": "1",
      "135": "1",
      "136": "1",
      "137": "1",
      "150": "1",
      "151": "1",
      "152": "1",
      "167": "1"
    },
    "3": {
      "85": "1",
      "86": "1",
      "87": "1",
      "88": "1",
      "89": "1",
      "101": "1",
      "105": "1",
      "117": "1",
      "121": "1",
      "133": "1",
      "137": "1",
      "149": "1",
      "150": "1",
      "151": "1",
      "152": "1",
      "153": "1"
    },
    "4": {
      "87": "1",
      "102": "1",
      "103": "1",
      "104": "1",
      "117": "1",
      "118": "1",
      "119": "1",
      "120": "1",
      "121": "1",
      "134": "1",
      "135": "1",
      "136": "1",
      "151": "1"
    },
    "5": {
      "103": "1",
      "118": "1",
      "119": "1",
      "120": "1",
      "135": "1"
    }
  },
  "GoldTileCount": 0,
  "GasolineCount": 0,
  "TileItemArray": [],
  "TotalItemNum": 11,
  "MoveVect": [
    0.0,
    0.0
  ],
  "TileTotalNum": 0,
  "TileLevelHardType": "Hard",
  "TotalCount": 120
}