{
  "AllLayerTileDict": {
    "1": {
      "35": "1",
      "195": "1",
      "98": "1",
      "130": "1",
      "59": "1",
      "91": "1",
      "123": "1",
      "155": "1",
      "187": "1",
      "101": "1",
      "103": "1",
      "105": "1",
      "137": "1",
      "135": "1",
      "133": "1"
    },
    "2": {
      "102": "1",
      "104": "1",
      "106": "1",
      "134": "1",
      "131": "1",
      "99": "1",
      "138": "1",
      "136": "1",
      "36": "1",
      "196": "1",
      "74": "1",
      "170": "1"
    },
    "3": {
      "37": "1",
      "197": "1",
      "116": "1",
      "120": "1",
      "122": "1",
      "124": "1",
      "92": "1",
      "156": "1",
      "118": "1",
      "154": "1",
      "90": "1"
    },
    "4": {
      "38": "1",
      "198": "1",
      "123": "1",
      "121": "1",
      "119": "1",
      "117": "1",
      "115": "1",
      "75": "1",
      "171": "1",
      "125": "1"
    },
    "5": {
      "39": "1",
      "199": "1",
      "124": "1",
      "122": "1",
      "120": "1",
      "118": "1",
      "116": "1",
      "59": "1",
      "114": "1",
      "187": "1",
      "92": "1",
      "156": "1"
    }
  },
  "GoldTileLocDict": {},
  "GoldTileCount": 0,
  "TileItemArray": [
    3,
    6,
    8,
    4,
    9,
    12
  ],
  "TotalItemNum": 9,
  "MoveVect": [
    -0.5,
    0.0
  ],
  "TileTotalNum": 0,
  "TileLevelHardType": "Normal",
  "TotalCount": 60
}