{
  "AllLayerTileDict": {
    "1": {
      "100": "1",
      "132": "1",
      "102": "1",
      "134": "1",
      "104": "1",
      "136": "1",
      "106": "1",
      "138": "1",
      "166": "1",
      "70": "1",
      "168": "1",
      "72": "1",
      "162": "1",
      "172": "1",
      "196": "1",
      "202": "1",
      "199": "1",
      "17": "-2",
      "29": "-2"
    },
    "2": {
      "69": "1",
      "73": "1",
      "55": "1",
      "99": "1",
      "101": "1",
      "103": "1",
      "105": "1",
      "107": "1",
      "131": "1",
      "133": "1",
      "135": "1",
      "137": "1",
      "139": "1",
      "163": "1",
      "165": "1",
      "167": "1",
      "169": "1",
      "171": "1",
      "198": "1",
      "200": "1",
      "195": "1",
      "203": "1",
      "17": "-2",
      "29": "-2"
    },
    "3": {
      "70": "1",
      "72": "1",
      "181": "1",
      "185": "1",
      "178": "1",
      "188": "1",
      "116": "1",
      "118": "1",
      "120": "1",
      "122": "1",
      "151": "1",
      "17": "-2",
      "29": "-2"
    },
    "4": {
      "134": "1",
      "136": "1",
      "87": "1",
      "132": "1",
      "138": "1",
      "166": "1",
      "168": "1",
      "179": "1",
      "187": "1",
      "69": "1",
      "73": "1",
      "55": "1",
      "17": "-2",
      "29": "-2"
    },
    "5": {
      "117": "1",
      "121": "1",
      "70": "1",
      "72": "1",
      "149": "1",
      "153": "1",
      "180": "1",
      "186": "1",
      "131": "1",
      "139": "1",
      "103": "1",
      "39": "1",
      "68": "1",
      "74": "1",
      "135": "1",
      "167": "1",
      "17": "-2",
      "29": "-2"
    },
    "6": {
      "17": "-2",
      "29": "-2"
    }
  },
  "GoldTileCount": 0,
  "GasolineCount": 0,
  "TileItemArray": [
    3,
    6,
    7,
    9,
    12,
    14,
    5,
    10,
    15,
    8
  ],
  "TotalItemNum": 10,
  "MoveVect": [
    0.0,
    0.5
  ],
  "TileTotalNum": 0,
  "TileLevelHardType": "Normal",
  "TotalCount": 90
}