{
  "AllLayerTileDict": {
    "1": {
      "68": "1",
      "70": "1",
      "72": "1",
      "74": "1",
      "132": "1",
      "134": "1",
      "136": "1",
      "138": "1",
      "196": "1",
      "198": "1",
      "200": "1",
      "202": "1",
      "103": "1"
    },
    "2": {
      "52": "1",
      "58": "1",
      "84": "1",
      "90": "1",
      "116": "1",
      "122": "1",
      "148": "1",
      "154": "1",
      "180": "1",
      "186": "1",
      "71": "1",
      "119": "1",
      "151": "1",
      "199": "1"
    },
    "3": {
      "69": "1",
      "73": "1",
      "55": "1",
      "101": "1",
      "105": "1",
      "133": "1",
      "137": "1",
      "165": "1",
      "169": "1",
      "200": "1",
      "198": "1",
      "135": "1",
      "167": "1"
    },
    "4": {
      "54": "1",
      "56": "1",
      "84": "1",
      "90": "1",
      "116": "1",
      "122": "1",
      "148": "1",
      "154": "1",
      "180": "1",
      "186": "1",
      "182": "1",
      "184": "1",
      "150": "1",
      "152": "1",
      "52": "1",
      "58": "1"
    },
    "5": {
      "67": "1",
      "99": "1",
      "131": "1",
      "163": "1",
      "75": "1",
      "107": "1",
      "139": "1",
      "171": "1",
      "166": "1",
      "55": "1",
      "168": "1"
    },
    "6": {
      "84": "1",
      "90": "1",
      "116": "1",
      "122": "1",
      "148": "1",
      "154": "1",
      "184": "1",
      "182": "1",
      "56": "1",
      "54": "1"
    },
    "7": {
      "39": "1",
      "69": "1",
      "73": "1",
      "101": "1",
      "105": "1",
      "133": "1",
      "137": "1",
      "131": "1",
      "139": "1",
      "37": "1",
      "41": "1",
      "181": "1",
      "179": "1",
      "183": "1",
      "185": "1",
      "187": "1"
    }
  },
  "GoldTileCount": 0,
  "GasolineCount": 0,
  "TileItemArray": [
    4,
    6,
    7,
    8,
    9,
    10,
    5,
    3,
    2,
    11
  ],
  "TotalItemNum": 10,
  "MoveVect": [
    0.0,
    0.0
  ],
  "TileTotalNum": 0,
  "TileLevelHardType": "Normal",
  "TotalCount": 93
}