{
  "AllLayerTileDict": {
    "1": {
      "17": "1",
      "29": "1",
      "50": "1",
      "60": "1",
      "149": "1",
      "153": "1",
      "116": "1",
      "122": "1",
      "83": "1",
      "91": "1",
      "215": "1",
      "194": "1",
      "196": "1",
      "202": "1",
      "204": "1",
      "36": "1",
      "42": "1"
    },
    "2": {
      "34": "1",
      "44": "1",
      "21": "1",
      "25": "1",
      "82": "1",
      "92": "1",
      "115": "1",
      "123": "1",
      "148": "1",
      "154": "1",
      "181": "1",
      "185": "1",
      "178": "1",
      "188": "1",
      "199": "1",
      "68": "1",
      "74": "1",
      "101": "1",
      "105": "1",
      "134": "1",
      "136": "1"
    },
    "3": {
      "19": "1",
      "27": "1",
      "67": "1",
      "75": "1",
      "100": "1",
      "106": "1",
      "133": "1",
      "137": "1",
      "182": "1",
      "184": "1",
      "163": "1",
      "171": "1",
      "38": "1",
      "40": "1"
    },
    "4": {
      "18": "1",
      "28": "1",
      "22": "1",
      "24": "1",
      "66": "1",
      "76": "1",
      "115": "1",
      "123": "1",
      "148": "1",
      "154": "1",
      "166": "1",
      "168": "1"
    },
    "5": {
      "19": "1",
      "27": "1",
      "38": "1",
      "40": "1",
      "67": "1",
      "75": "1",
      "116": "1",
      "122": "1",
      "165": "1",
      "169": "1",
      "114": "1",
      "124": "1",
      "147": "1",
      "155": "1",
      "151": "1"
    },
    "6": {
      "135": "1",
      "54": "1",
      "56": "1",
      "36": "1",
      "42": "1",
      "68": "1",
      "74": "1",
      "99": "1",
      "107": "1",
      "131": "1",
      "139": "1",
      "166": "1",
      "168": "1",
      "117": "1",
      "121": "1",
      "18": "1",
      "28": "1"
    },
    "7": {
      "35": "1",
      "43": "1",
      "136": "1",
      "67": "1",
      "72": "1",
      "70": "1",
      "134": "1",
      "100": "1",
      "138": "1",
      "132": "1",
      "106": "1",
      "75": "1",
      "165": "1",
      "167": "1",
      "169": "1",
      "102": "1",
      "104": "1",
      "98": "1",
      "130": "1",
      "108": "1",
      "140": "1"
    },
    "8": {
      "156": "1",
      "150": "1",
      "152": "1",
      "146": "1",
      "114": "1",
      "124": "1",
      "50": "1",
      "60": "1",
      "82": "1",
      "92": "1",
      "148": "1",
      "154": "1"
    }
  },
  "GoldTileCount": 0,
  "GasolineCount": 0,
  "TileItemArray": [
    3,
    4,
    5,
    8,
    9,
    10,
    15
  ],
  "TotalItemNum": 7,
  "MoveVect": [
    0.0,
    0.0
  ],
  "TileTotalNum": 0,
  "TileLevelHardType": "Normal",
  "TotalCount": 129
}