{
  "AllLayerTileDict": {
    "1": {
      "67": 1,
      "163": 1,
      "69": 1,
      "165": 1,
      "71": 1,
      "167": 1,
      "73": 1,
      "169": 1,
      "75": 1,
      "171": 1
    },
    "2": {
      "84": 1,
      "148": 1,
      "86": 1,
      "150": 1,
      "88": 1,
      "152": 1,
      "90": 1,
      "154": 1
    },
    "3": {
      "98": 1,
      "100": 1,
      "102": 1,
      "104": 1,
      "106": 1,
      "108": 1,
      "130": 1,
      "132": 1,
      "134": 1,
      "136": 1,
      "138": 1,
      "140": 1,
      "68": 1,
      "164": 1,
      "70": 1,
      "166": 1,
      "72": 1,
      "168": 1,
      "74": 1,
      "170": 1
    },
    "4": {
      "67": 1,
      "69": 1,
      "71": 1,
      "73": 1,
      "75": 1,
      "163": 1,
      "165": 1,
      "167": 1,
      "169": 1,
      "171": 1,
      "113": 1,
      "115": 1,
      "117": 1,
      "119": 1,
      "121": 1,
      "123": 1,
      "125": 1
    },
    "5": {
      "120": 1,
      "114": 1,
      "52": 1,
      "180": 1,
      "54": 1,
      "182": 1,
      "56": 1,
      "184": 1,
      "58": 1,
      "186": 1,
      "118": 1,
      "116": 1,
      "122": 1,
      "124": 1
    }
  },
  "TileItemArray": [
    4,
    5,
    6,
    7,
    8,
    9,
    10
  ],
  "TotalItemNum": 7,
  "MoveVect": [
    0.0,
    0.0
  ],
  "TileLevelHardType": "Normal",
  "TotalCount": 69
}