{
  "AllLayerTileDict": {
    "1": {
      "52": "1",
      "54": "1",
      "56": "1",
      "58": "1",
      "60": "1",
      "50": "1",
      "98": "1",
      "100": "1",
      "102": "1",
      "104": "1",
      "106": "1",
      "108": "1"
    },
    "2": {
      "66": "1",
      "70": "1",
      "68": "1",
      "72": "1",
      "74": "1",
      "76": "1",
      "114": "1",
      "116": "1",
      "118": "1",
      "120": "1",
      "122": "1",
      "124": "1"
    },
    "3": {
      "82": "1",
      "84": "1",
      "86": "1",
      "88": "1",
      "90": "1",
      "92": "1",
      "130": "1",
      "132": "1",
      "134": "1",
      "136": "1",
      "138": "1",
      "140": "1"
    },
    "4": {
      "98": "1",
      "100": "1",
      "102": "1",
      "104": "1",
      "106": "1",
      "108": "1",
      "146": "1",
      "148": "1",
      "150": "1",
      "152": "1",
      "154": "1",
      "156": "1"
    },
    "5": {
      "114": "1",
      "116": "1",
      "118": "1",
      "120": "1",
      "122": "1",
      "124": "1",
      "162": "1",
      "164": "1",
      "166": "1",
      "168": "1",
      "170": "1",
      "172": "1"
    },
    "6": {
      "130": "1",
      "132": "1",
      "134": "1",
      "136": "1",
      "138": "1",
      "140": "1",
      "178": "1",
      "180": "1",
      "182": "1",
      "184": "1",
      "186": "1",
      "188": "1"
    },
    "7": {
      "172": "1",
      "170": "1",
      "168": "1",
      "166": "1",
      "164": "1",
      "162": "1",
      "124": "1",
      "122": "1",
      "120": "1",
      "118": "1",
      "116": "1",
      "114": "1"
    },
    "8": {
      "146": "1",
      "148": "1",
      "150": "1",
      "152": "1",
      "154": "1",
      "156": "1",
      "98": "1",
      "100": "1",
      "102": "1",
      "104": "1",
      "106": "1",
      "108": "1"
    },
    "9": {
      "90": "1",
      "88": "1",
      "86": "1",
      "84": "1",
      "82": "1",
      "92": "1",
      "119": "1",
      "151": "1",
      "183": "1"
    }
  },
  "GoldTileCount": 0,
  "GasolineCount": 0,
  "TileItemArray": [
    4,
    5,
    6,
    7,
    10,
    11,
    15,
    16
  ],
  "TotalItemNum": 8,
  "MoveVect": [
    0.0,
    0.0
  ],
  "TileTotalNum": 0,
  "TileLevelHardType": "Normal",
  "TotalCount": 105
}