{
  "AllLayerTileDict": {
    "1": {
      "36": "1",
      "196": "1",
      "38": "1",
      "198": "1",
      "40": "1",
      "200": "1",
      "42": "1",
      "202": "1",
      "167": "1",
      "71": "1",
      "103": "1",
      "135": "1"
    },
    "2": {
      "87": "1",
      "51": "1",
      "57": "1",
      "185": "1",
      "53": "1",
      "151": "1",
      "55": "1",
      "59": "1",
      "119": "1",
      "179": "1",
      "181": "1",
      "187": "1",
      "183": "1"
    },
    "3": {
      "76": "1",
      "70": "1",
      "164": "1",
      "166": "1",
      "66": "1",
      "72": "1",
      "74": "1",
      "135": "1",
      "168": "1",
      "162": "1",
      "68": "1",
      "170": "1",
      "103": "1",
      "172": "1"
    },
    "4": {
      "81": "1",
      "83": "1",
      "85": "1",
      "87": "1",
      "89": "1",
      "91": "1",
      "93": "1",
      "145": "1",
      "147": "1",
      "149": "1",
      "151": "1",
      "153": "1",
      "155": "1",
      "157": "1",
      "119": "1"
    },
    "5": {
      "98": "1",
      "100": "1",
      "102": "1",
      "104": "1",
      "106": "1",
      "108": "1",
      "130": "1",
      "132": "1",
      "134": "1",
      "136": "1",
      "138": "1",
      "140": "1"
    },
    "6": {
      "115": "1",
      "155": "1",
      "187": "1",
      "117": "1",
      "153": "1",
      "185": "1",
      "123": "1",
      "83": "1",
      "51": "1",
      "121": "1",
      "85": "1",
      "53": "1",
      "113": "1",
      "157": "1",
      "189": "1",
      "81": "1",
      "125": "1",
      "49": "1"
    }
  },
  "GoldTileCount": 0,
  "GasolineCount": 0,
  "TileItemArray": [],
  "TotalItemNum": 10,
  "MoveVect": [
    0.0,
    0.0
  ],
  "TileTotalNum": 0,
  "TileLevelHardType": "Hard",
  "TotalCount": 84
}