{
  "AllLayerTileDict": {
    "1": {
      "18": "1",
      "210": "1",
      "28": "1",
      "220": "1",
      "24": "1",
      "216": "1",
      "22": "1",
      "214": "1",
      "114": "1",
      "124": "1",
      "85": "1",
      "89": "1",
      "149": "1",
      "153": "1"
    },
    "2": {
      "204": "1",
      "34": "1",
      "194": "1",
      "136": "1",
      "134": "1",
      "39": "1",
      "199": "1",
      "115": "1",
      "44": "1",
      "123": "1",
      "104": "1",
      "102": "1"
    },
    "3": {
      "50": "1",
      "178": "1",
      "52": "1",
      "180": "1",
      "54": "1",
      "182": "1",
      "56": "1",
      "184": "1",
      "58": "1",
      "186": "1",
      "60": "1",
      "188": "1",
      "131": "1",
      "139": "1",
      "99": "1",
      "107": "1",
      "87": "1",
      "119": "1",
      "151": "1",
      "117": "20",
      "121": "20"
    },
    "4": {
      "164": "1",
      "170": "1",
      "132": "1",
      "138": "1",
      "98": "1",
      "108": "1",
      "66": "1",
      "76": "1",
      "100": "1",
      "106": "1",
      "68": "1",
      "74": "1",
      "130": "1",
      "140": "1",
      "162": "1",
      "172": "1",
      "70": "1",
      "72": "1",
      "166": "1",
      "168": "1",
      "103": "1",
      "135": "1"
    },
    "5": {
      "85": "1",
      "83": "1",
      "115": "1",
      "147": "1",
      "89": "1",
      "91": "1",
      "123": "1",
      "149": "1",
      "153": "1",
      "155": "1",
      "119": "1",
      "151": "1",
      "87": "1"
    },
    "6": {
      "66": "1",
      "98": "1",
      "130": "1",
      "162": "1",
      "164": "1",
      "166": "1",
      "168": "1",
      "170": "1",
      "172": "1",
      "140": "1",
      "108": "1",
      "76": "1",
      "74": "1",
      "72": "1",
      "70": "1",
      "68": "1",
      "135": "1",
      "103": "1"
    },
    "7": {
      "49": "1",
      "51": "1",
      "53": "1",
      "55": "1",
      "57": "1",
      "59": "1",
      "61": "1",
      "93": "1",
      "125": "1",
      "157": "1",
      "189": "1",
      "187": "1",
      "185": "1",
      "183": "1",
      "181": "1",
      "179": "1",
      "177": "1",
      "145": "1",
      "113": "1",
      "81": "1",
      "87": "1",
      "119": "20",
      "151": "1"
    }
  },
  "GoldTileCount": 0,
  "TileItemArray": [],
  "TotalItemNum": 12,
  "MoveVect": [
    0.0,
    0.0
  ],
  "TileTotalNum": 0,
  "TileLevelHardType": "Normal",
  "TotalCount": 123
}