{
  "AllLayerTileDict": {
    "1": {
      "119": "1"
    },
    "2": {
      "134": "1",
      "136": "1",
      "102": "1",
      "104": "1"
    },
    "3": {
      "149": "1",
      "151": "1",
      "153": "1",
      "121": "1",
      "89": "1",
      "87": "1",
      "85": "1",
      "117": "1",
      "119": "1"
    },
    "4": {
      "164": "1",
      "166": "1",
      "168": "1",
      "170": "1",
      "138": "1",
      "106": "1",
      "74": "1",
      "72": "1",
      "70": "1",
      "68": "1",
      "100": "1",
      "132": "1",
      "102": "1",
      "104": "1_1",
      "134": "1_1",
      "136": "1"
    },
    "5": {
      "179": "1",
      "181": "1",
      "183": "1",
      "185": "1",
      "187": "1",
      "155": "1",
      "123": "1",
      "91": "1",
      "59": "1",
      "57": "1",
      "55": "1",
      "53": "1",
      "51": "1",
      "83": "1",
      "115": "1",
      "147": "1",
      "85": "1_1",
      "87": "1_1",
      "89": "1_1",
      "117": "1_1",
      "119": "1",
      "121": "1_1",
      "149": "1_1",
      "151": "1_1",
      "153": "1_1"
    },
    "6": {
      "34": "1",
      "36": "1",
      "38": "1",
      "40": "1",
      "42": "1",
      "44": "1",
      "76": "1",
      "108": "1",
      "140": "1",
      "172": "1",
      "204": "1",
      "202": "1",
      "200": "1",
      "198": "1",
      "196": "1",
      "194": "1",
      "162": "1",
      "130": "1",
      "98": "1",
      "66": "1",
      "68": "1",
      "70": "1_1",
      "72": "1_1",
      "74": "1",
      "106": "1_1",
      "138": "1_1",
      "170": "1",
      "168": "1_1",
      "166": "1_1",
      "164": "1",
      "132": "1_1",
      "100": "1_1",
      "102": "1",
      "104": "1",
      "136": "1",
      "134": "1"
    },
    "7": {
      "209": "1_1",
      "211": "1_1",
      "213": "1_1",
      "215": "1_1",
      "217": "1_1",
      "219": "1_1",
      "221": "1_1",
      "189": "1_1",
      "157": "1_1",
      "125": "1_1",
      "93": "1_1",
      "61": "1_1",
      "29": "1_1",
      "27": "1_1",
      "25": "1_1",
      "23": "1_1",
      "21": "1_1",
      "19": "1_1",
      "17": "1_1",
      "49": "1_1",
      "81": "1_1",
      "113": "1_1",
      "145": "1_1",
      "177": "1_1",
      "179": "1",
      "181": "1",
      "183": "1",
      "185": "1",
      "187": "1",
      "155": "1",
      "123": "1",
      "91": "1",
      "59": "1",
      "51": "1",
      "53": "1",
      "57": "1",
      "83": "1",
      "85": "1",
      "89": "1",
      "55": "1",
      "147": "1",
      "149": "1",
      "153": "1",
      "115": "1"
    }
  },
  "GoldTileCount": 0,
  "TileItemArray": [],
  "TotalItemNum": 10,
  "MoveVect": [
    0.0,
    0.0
  ],
  "TileTotalNum": 0,
  "TileLevelHardType": "Normal",
  "TotalCount": 135
}