{
  "AllLayerTileDict": {
    "1": {
      "65": "1",
      "161": "1",
      "77": "1",
      "173": "1",
      "83": "1",
      "147": "1",
      "91": "1",
      "155": "1",
      "101": "1",
      "133": "1",
      "105": "1",
      "137": "1",
      "119": "1"
    },
    "2": {
      "103": "1",
      "135": "1",
      "84": "1",
      "90": "1",
      "116": "1",
      "122": "1",
      "148": "1",
      "154": "1",
      "50": "1",
      "60": "1",
      "178": "1",
      "188": "1",
      "82": "1",
      "92": "1",
      "146": "1",
      "156": "1"
    },
    "3": {
      "102": "1",
      "104": "1",
      "134": "1",
      "136": "1",
      "67": "1",
      "75": "1",
      "99": "1",
      "107": "1",
      "131": "1",
      "139": "1",
      "163": "1",
      "171": "1",
      "195": "1",
      "203": "1",
      "35": "1",
      "43": "1"
    },
    "4": {
      "87": "1",
      "119": "1",
      "151": "1",
      "52": "1",
      "58": "1",
      "83": "1",
      "91": "1",
      "115": "1",
      "123": "1",
      "147": "1",
      "155": "1",
      "180": "1",
      "186": "1"
    },
    "5": {
      "103": "1",
      "135": "1",
      "131": "1",
      "99": "1",
      "139": "1",
      "107": "1",
      "67": "1",
      "163": "1",
      "75": "1",
      "171": "1",
      "53": "1",
      "181": "1",
      "57": "1",
      "185": "1"
    },
    "6": {
      "54": "1",
      "182": "1",
      "56": "1",
      "184": "1",
      "51": "1",
      "59": "1",
      "83": "1",
      "91": "1",
      "115": "1",
      "123": "1",
      "147": "1",
      "155": "1",
      "179": "1",
      "187": "1",
      "119": "1"
    }
  },
  "GoldTileCount": 0,
  "GasolineCount": 0,
  "TileItemArray": [],
  "TotalItemNum": 10,
  "MoveVect": [
    0.0,
    0.0
  ],
  "TileTotalNum": 0,
  "TileLevelHardType": "Normal",
  "TotalCount": 87
}