{
  "AllLayerTileDict": {
    "1": {
      "49": "1",
      "61": "1",
      "81": "1",
      "93": "1",
      "113": "1",
      "125": "1",
      "145": "1",
      "157": "1",
      "177": "1",
      "189": "1",
      "209": "1",
      "221": "1",
      "67": "1",
      "75": "1",
      "99": "1",
      "107": "1",
      "131": "1",
      "139": "1",
      "163": "1",
      "171": "1",
      "195": "1",
      "203": "1",
      "233": "1",
      "229": "1",
      "85": "1",
      "89": "1",
      "117": "1",
      "121": "1",
      "149": "1",
      "153": "1",
      "181": "1",
      "185": "1",
      "103": "1",
      "135": "1",
      "167": "1",
      "231": "1",
      "39": "-2"
    },
    "2": {
      "66": "1",
      "76": "1",
      "98": "1",
      "108": "1",
      "130": "1",
      "140": "1",
      "162": "1",
      "172": "1",
      "194": "1",
      "204": "1",
      "84": "1",
      "90": "1",
      "116": "1",
      "122": "1",
      "148": "1",
      "154": "1",
      "180": "1",
      "186": "1",
      "102": "1",
      "104": "1",
      "134": "1",
      "136": "1",
      "166": "1",
      "168": "1",
      "214": "1",
      "216": "1",
      "39": "-2"
    },
    "3": {
      "83": "1",
      "91": "1",
      "115": "1",
      "123": "1",
      "147": "1",
      "155": "1",
      "179": "1",
      "187": "1",
      "117": "1",
      "121": "1",
      "153": "1",
      "39": "-2",
      "149": "1",
      "199": "1"
    },
    "4": {
      "134": "1",
      "136": "1",
      "106": "1",
      "138": "1",
      "164": "1",
      "170": "1",
      "132": "1",
      "100": "1",
      "216": "1",
      "39": "-2",
      "214": "1"
    },
    "5": {
      "133": "1",
      "137": "1",
      "39": "-2",
      "231": "1",
      "229": "1",
      "233": "1"
    },
    "6": {
      "39": "-2"
    }
  },
  "GoldTileCount": 0,
  "GasolineCount": 0,
  "TileItemArray": [],
  "TotalItemNum": 11,
  "MoveVect": [
    0.0,
    -1.0
  ],
  "TileTotalNum": 0,
  "TileLevelHardType": "Normal",
  "TotalCount": 96
}