{
  "AllLayerTileDict": {
    "1": {
      "23": "1",
      "215": "1",
      "83": "1",
      "91": "1",
      "147": "1",
      "155": "1",
      "55": "1",
      "125": "1",
      "113": "1",
      "87": "1",
      "53": "1",
      "57": "1",
      "181": "1",
      "185": "1",
      "119": "1",
      "151": "1",
      "183": "1",
      "85": "1",
      "117": "1",
      "149": "1",
      "89": "1",
      "121": "1",
      "153": "1",
      "123": "1",
      "115": "1"
    },
    "2": {
      "70": "1",
      "72": "1",
      "166": "1",
      "168": "1",
      "98": "1",
      "108": "1",
      "130": "1",
      "140": "1",
      "116": "1",
      "122": "1",
      "148": "1",
      "154": "1",
      "102": "1",
      "104": "1",
      "134": "1",
      "136": "1",
      "84": "1",
      "90": "1",
      "39": "1",
      "199": "1"
    },
    "3": {
      "147": "1",
      "155": "1",
      "115": "1",
      "123": "1",
      "83": "1",
      "91": "1",
      "165": "1",
      "169": "1",
      "133": "1",
      "137": "1",
      "101": "1",
      "105": "1",
      "69": "1",
      "73": "1",
      "183": "1",
      "151": "1",
      "119": "1",
      "87": "1",
      "55": "1"
    },
    "4": {
      "164": "1",
      "170": "1",
      "132": "1",
      "138": "1",
      "100": "1",
      "106": "1",
      "68": "1",
      "74": "1",
      "150": "1",
      "152": "1",
      "182": "1",
      "184": "1",
      "118": "1",
      "120": "1",
      "86": "1",
      "88": "1",
      "54": "1",
      "56": "1"
    },
    "5": {
      "181": "1",
      "185": "1",
      "149": "1",
      "153": "1",
      "117": "1",
      "121": "1",
      "85": "1",
      "89": "1",
      "53": "1",
      "57": "1",
      "199": "1",
      "167": "1",
      "135": "1",
      "103": "1",
      "71": "1",
      "39": "1"
    },
    "6": {
      "198": "1",
      "166": "1",
      "134": "1",
      "102": "1",
      "70": "1",
      "38": "1",
      "200": "1",
      "168": "1",
      "136": "1",
      "104": "1",
      "72": "1",
      "40": "1"
    },
    "7": {
      "87": "1",
      "85": "1",
      "89": "1",
      "55": "1",
      "149": "1",
      "151": "1",
      "153": "1",
      "183": "1",
      "117": "1",
      "121": "1",
      "115": "1",
      "123": "1",
      "119": "1"
    }
  },
  "TileItemArray": [],
  "TotalItemNum": 14,
  "MoveVect": [
    0.0,
    0.0
  ],
  "TileTotalNum": 0,
  "TileLevelHardType": "Normal",
  "TotalCount": 123
}