{
  "AllLayerTileDict": {
    "1": {
      "34": "1",
      "194": "1",
      "44": "1",
      "204": "1",
      "68": "1",
      "164": "1",
      "38": "1",
      "198": "1",
      "74": "1",
      "170": "1",
      "40": "1",
      "200": "1",
      "116": "1",
      "122": "1",
      "113": "1",
      "125": "1"
    },
    "2": {
      "33": "1",
      "45": "1",
      "193": "1",
      "205": "1",
      "35": "1",
      "43": "1",
      "195": "1",
      "203": "1",
      "97": "1",
      "109": "1",
      "129": "1",
      "141": "1",
      "53": "1",
      "181": "1",
      "55": "1",
      "183": "1",
      "57": "1",
      "185": "1",
      "99": "1",
      "107": "1",
      "67": "1",
      "75": "1",
      "131": "1",
      "139": "1",
      "163": "1",
      "171": "1"
    },
    "3": {
      "50": "1",
      "178": "1",
      "52": "1",
      "180": "1",
      "54": "1",
      "182": "1",
      "56": "1",
      "184": "1",
      "58": "1",
      "186": "1",
      "60": "1",
      "188": "1",
      "114": "1",
      "124": "1"
    },
    "4": {
      "65": "1",
      "161": "1",
      "67": "1",
      "163": "1",
      "69": "1",
      "165": "1",
      "71": "1",
      "167": "1",
      "73": "1",
      "169": "1",
      "75": "1",
      "171": "1",
      "77": "1",
      "173": "1",
      "99": "1",
      "107": "1",
      "97": "1",
      "109": "1",
      "131": "1",
      "139": "1",
      "129": "1",
      "141": "1"
    },
    "5": {
      "81": "1",
      "145": "1",
      "83": "1",
      "147": "1",
      "85": "1",
      "149": "1",
      "87": "1",
      "151": "1",
      "89": "1",
      "153": "1",
      "91": "1",
      "155": "1",
      "93": "1",
      "157": "1",
      "113": "1",
      "125": "1",
      "115": "1",
      "123": "1"
    },
    "6": {
      "97": "1",
      "129": "1",
      "109": "1",
      "141": "1",
      "65": "1",
      "73": "1",
      "75": "1",
      "77": "1",
      "71": "1",
      "69": "1",
      "67": "1",
      "161": "1",
      "173": "1",
      "171": "1",
      "169": "1",
      "167": "1",
      "165": "1",
      "163": "1",
      "99": "1",
      "131": "1",
      "107": "1",
      "139": "1",
      "118": "1",
      "120": "1"
    }
  },
  "TileItemArray": [],
  "TotalItemNum": 10,
  "MoveVect": [
    0.0,
    0.0
  ],
  "TileTotalNum": 0,
  "TileLevelHardType": "Hard",
  "TotalCount": 120
}