{
  "AllLayerTileDict": {
    "1": {
      "36": "1",
      "38": "1",
      "40": "1",
      "42": "1",
      "66": "1",
      "98": "1",
      "130": "1",
      "162": "1",
      "196": "1",
      "198": "1",
      "200": "1",
      "202": "1",
      "172": "1",
      "140": "1",
      "108": "1",
      "76": "1",
      "204": "1",
      "102": "1",
      "136": "1",
      "44": "1",
      "34": "1",
      "104": "1",
      "134": "1",
      "194": "1"
    },
    "2": {
      "51": "1",
      "179": "1",
      "59": "1",
      "187": "1",
      "55": "1",
      "183": "1",
      "119": "1",
      "124": "1",
      "114": "1"
    },
    "3": {
      "104": "1",
      "102": "1",
      "71": "1",
      "167": "1",
      "74": "1",
      "170": "1",
      "68": "1",
      "164": "1",
      "98": "1",
      "130": "1",
      "136": "1",
      "134": "1",
      "140": "1",
      "108": "1"
    },
    "4": {
      "85": "1",
      "83": "1",
      "87": "1",
      "147": "1",
      "151": "1",
      "149": "1",
      "153": "1",
      "91": "1",
      "115": "1",
      "123": "1",
      "89": "1",
      "155": "1",
      "113": "1",
      "125": "1"
    },
    "5": {
      "116": "1",
      "134": "1",
      "122": "1",
      "168": "1",
      "82": "1",
      "166": "1",
      "102": "1",
      "92": "1",
      "72": "1",
      "124": "1",
      "114": "1",
      "104": "1",
      "136": "1",
      "70": "1",
      "84": "1",
      "90": "1",
      "148": "1",
      "154": "1",
      "156": "1",
      "146": "1"
    },
    "6": {
      "139": "1",
      "169": "1",
      "131": "1",
      "99": "1",
      "73": "1",
      "167": "1",
      "75": "1",
      "71": "1",
      "69": "1",
      "67": "1",
      "107": "1",
      "163": "1",
      "171": "1",
      "119": "1",
      "165": "1",
      "117": "1",
      "121": "1"
    },
    "7": {
      "56": "1",
      "84": "1",
      "60": "1",
      "50": "1",
      "90": "1",
      "52": "1",
      "54": "1",
      "148": "1",
      "136": "1",
      "134": "1",
      "154": "1",
      "58": "1",
      "92": "1",
      "124": "1",
      "156": "1",
      "186": "1",
      "184": "1",
      "182": "1",
      "180": "1",
      "146": "1",
      "114": "1",
      "82": "1",
      "104": "1",
      "102": "1",
      "116": "1",
      "122": "1",
      "178": "1",
      "188": "1"
    }
  },
  "TileItemArray": [],
  "TotalItemNum": 14,
  "MoveVect": [
    0.0,
    0.0
  ],
  "TileTotalNum": 0,
  "TileLevelHardType": "Normal",
  "TotalCount": 126
}