{
  "AllLayerTileDict": {
    "1": {
      "17": "1",
      "49": "1",
      "81": "1",
      "113": "1",
      "19": "1",
      "21": "1",
      "23": "1",
      "221": "1",
      "219": "1",
      "217": "1",
      "215": "1",
      "189": "1",
      "157": "1",
      "125": "1",
      "102": "1",
      "104": "1",
      "136": "1",
      "134": "1"
    },
    "2": {
      "162": "1",
      "194": "1",
      "196": "1",
      "130": "1",
      "98": "1",
      "42": "1",
      "44": "1",
      "76": "1",
      "40": "1",
      "38": "1",
      "198": "1",
      "200": "1",
      "108": "1",
      "140": "1",
      "34": "1",
      "204": "1",
      "119": "1"
    },
    "3": {
      "51": "1",
      "83": "1",
      "115": "1",
      "53": "1",
      "55": "1",
      "57": "1",
      "147": "1",
      "187": "1",
      "155": "1",
      "123": "1",
      "91": "1",
      "59": "1",
      "179": "1",
      "181": "1",
      "183": "1",
      "185": "1",
      "102": "1",
      "104": "1",
      "136": "1",
      "134": "1"
    },
    "4": {
      "162": "1",
      "130": "1",
      "98": "1",
      "66": "1",
      "194": "1",
      "196": "1",
      "198": "1",
      "200": "1",
      "202": "1",
      "119": "1",
      "36": "1",
      "38": "1",
      "40": "1",
      "42": "1",
      "44": "1",
      "76": "1",
      "108": "1",
      "140": "1",
      "172": "1"
    },
    "5": {
      "83": "1",
      "115": "1",
      "147": "1",
      "179": "1",
      "181": "1",
      "183": "1",
      "185": "1",
      "59": "1",
      "57": "1",
      "55": "1",
      "53": "1",
      "91": "1",
      "123": "1",
      "155": "1",
      "102": "1",
      "104": "1",
      "136": "1",
      "134": "1"
    },
    "6": {
      "100": "1",
      "132": "1",
      "164": "1",
      "166": "1",
      "168": "1",
      "70": "1",
      "72": "1",
      "74": "1",
      "106": "1",
      "138": "1",
      "119": "1"
    },
    "7": {
      "134": "1",
      "136": "1",
      "104": "1",
      "102": "1",
      "83": "1",
      "115": "1",
      "147": "1",
      "179": "1",
      "181": "1",
      "183": "1",
      "185": "1",
      "53": "1",
      "55": "1",
      "57": "1",
      "59": "1",
      "91": "1",
      "123": "1",
      "155": "1"
    },
    "8": {
      "119": "1",
      "66": "1",
      "98": "1",
      "130": "1",
      "162": "1",
      "194": "1",
      "196": "1",
      "198": "1",
      "200": "1",
      "202": "1",
      "36": "1",
      "38": "1",
      "40": "1",
      "42": "1",
      "44": "1",
      "76": "1",
      "108": "1",
      "140": "1",
      "172": "1"
    },
    "9": {
      "102": "1",
      "104": "1",
      "136": "1",
      "134": "1"
    }
  },
  "TileItemArray": [],
  "TotalItemNum": 14,
  "MoveVect": [
    0.0,
    0.0
  ],
  "TileTotalNum": 0,
  "TileLevelHardType": "Normal",
  "TotalCount": 144
}