{
  "AllLayerTileDict": {
    "1": {
      "113": "1",
      "125": "1",
      "145": "1",
      "157": "1",
      "177": "1",
      "189": "1",
      "209": "1",
      "211": "1",
      "213": "1",
      "215": "1",
      "217": "1",
      "219": "1",
      "221": "1",
      "179": "1",
      "181": "1",
      "183": "1",
      "185": "1",
      "187": "1"
    },
    "2": {
      "98": "1",
      "108": "1",
      "130": "1",
      "140": "1",
      "162": "1",
      "172": "1",
      "204": "1",
      "202": "1",
      "200": "1",
      "198": "1",
      "196": "1",
      "194": "1",
      "164": "1",
      "166": "1",
      "168": "1",
      "170": "1"
    },
    "3": {
      "179": "1",
      "181": "1",
      "183": "1",
      "185": "1",
      "187": "1",
      "83": "1",
      "91": "1",
      "115": "1",
      "123": "1",
      "147": "1",
      "155": "1",
      "149": "1",
      "151": "1",
      "153": "1",
      "50": "1",
      "18": "1",
      "22": "1",
      "20": "1",
      "24": "1",
      "26": "1",
      "28": "1",
      "60": "1"
    },
    "4": {
      "166": "1",
      "164": "1",
      "68": "1",
      "74": "1",
      "132": "1",
      "138": "1",
      "100": "1",
      "106": "1",
      "168": "1",
      "170": "1",
      "35": "1",
      "37": "1",
      "39": "1",
      "41": "1",
      "43": "1"
    },
    "5": {
      "52": "1",
      "54": "1",
      "56": "1",
      "58": "1",
      "83": "1",
      "91": "1",
      "115": "1",
      "123": "1",
      "147": "1",
      "155": "1",
      "179": "1",
      "187": "1",
      "181": "1",
      "183": "1",
      "185": "1"
    },
    "6": {
      "68": "1",
      "100": "1",
      "132": "1",
      "164": "1",
      "166": "1",
      "168": "1",
      "170": "1",
      "138": "1",
      "106": "1",
      "74": "1",
      "70": "1",
      "72": "1"
    },
    "7": {
      "85": "1",
      "89": "1",
      "117": "1",
      "121": "1",
      "149": "1",
      "151": "1",
      "87": "1",
      "153": "1"
    },
    "8": {
      "68": "1",
      "70": "1",
      "72": "1",
      "74": "1",
      "100": "1",
      "132": "1",
      "164": "1",
      "166": "1",
      "168": "1",
      "170": "1",
      "106": "1",
      "138": "1"
    },
    "9": {
      "59": "1",
      "53": "1",
      "83": "1",
      "91": "1",
      "115": "1",
      "123": "1",
      "147": "1",
      "155": "1",
      "179": "1",
      "181": "1",
      "57": "1",
      "183": "1",
      "51": "1",
      "185": "1",
      "55": "1",
      "187": "1"
    },
    "10": {
      "34": "1",
      "36": "1",
      "38": "1",
      "40": "1",
      "42": "1",
      "44": "1",
      "132": "1",
      "138": "1",
      "100": "1",
      "106": "1",
      "68": "1",
      "74": "1",
      "164": "1",
      "166": "1",
      "168": "1",
      "170": "1"
    }
  },
  "TileItemArray": [],
  "TotalItemNum": 11,
  "MoveVect": [
    0.0,
    0.0
  ],
  "TileTotalNum": 0,
  "TileLevelHardType": "Normal",
  "TotalCount": 150
}