{
  "AllLayerTileDict": {
    "1": {
      "34": "1",
      "66": "1",
      "98": "1",
      "130": "1",
      "162": "1",
      "194": "1",
      "196": "1",
      "198": "1",
      "200": "1",
      "202": "1",
      "204": "1",
      "38": "-1",
      "138": "0",
      "90": "0",
      "42": "0",
      "86": "-1",
      "134": "-1"
    },
    "2": {
      "145": "1",
      "113": "1",
      "81": "1",
      "49": "1",
      "17": "1",
      "177": "1",
      "209": "1",
      "211": "1",
      "213": "1",
      "215": "1",
      "217": "1",
      "219": "1",
      "221": "1",
      "38": "-1",
      "138": "0",
      "90": "0",
      "42": "0",
      "86": "-1",
      "134": "-1"
    },
    "3": {
      "34": "1",
      "66": "1",
      "98": "1",
      "130": "1",
      "162": "1",
      "194": "1",
      "196": "1",
      "198": "1",
      "200": "1",
      "202": "1",
      "204": "1",
      "42": "0",
      "90": "0",
      "138": "0",
      "38": "-1",
      "86": "-1",
      "134": "-1"
    },
    "4": {
      "17": "1",
      "49": "1",
      "81": "1",
      "113": "1",
      "145": "1",
      "177": "1",
      "209": "1",
      "211": "1",
      "213": "1",
      "215": "1",
      "217": "1",
      "219": "1",
      "221": "1",
      "42": "0",
      "90": "0",
      "138": "0",
      "38": "-1",
      "86": "-1",
      "134": "-1"
    },
    "5": {
      "34": "1",
      "66": "1",
      "98": "1",
      "130": "1",
      "162": "1",
      "194": "1",
      "196": "1",
      "198": "1",
      "200": "1",
      "202": "1",
      "204": "1",
      "42": "0",
      "90": "0",
      "138": "0",
      "38": "-1",
      "86": "-1",
      "134": "-1"
    },
    "6": {
      "81": "1",
      "49": "1",
      "17": "1",
      "113": "1",
      "145": "1",
      "177": "1",
      "209": "1",
      "211": "1",
      "219": "1",
      "215": "1",
      "217": "1",
      "213": "1",
      "221": "1",
      "42": "0",
      "90": "0",
      "138": "0",
      "38": "-1",
      "86": "-1",
      "134": "-1"
    },
    "7": {
      "34": "1",
      "66": "1",
      "98": "1",
      "130": "1",
      "162": "1",
      "194": "1",
      "196": "1",
      "198": "1",
      "200": "1",
      "202": "1",
      "204": "1",
      "42": "0",
      "90": "0",
      "138": "0",
      "38": "-1",
      "86": "-1",
      "134": "-1"
    },
    "8": {
      "17": "1",
      "49": "1",
      "81": "1",
      "113": "1",
      "145": "1",
      "177": "1",
      "209": "1",
      "211": "1",
      "213": "1",
      "215": "1",
      "217": "1",
      "219": "1",
      "221": "1",
      "42": "0",
      "90": "0",
      "138": "0",
      "38": "-1",
      "86": "-1",
      "134": "-1"
    }
  },
  "TileItemArray": [],
  "TotalItemNum": 13,
  "MoveVect": [
    0.0,
    0.0
  ],
  "TileTotalNum": 0,
  "TileLevelHardType": "Normal",
  "TotalCount": 144
}