{
  "AllLayerTileDict": {
    "1": {
      "17": "1",
      "209": "1",
      "29": "1",
      "221": "1",
      "49": "1",
      "177": "1",
      "61": "1",
      "189": "1",
      "35": "1",
      "195": "1",
      "43": "1",
      "203": "1",
      "67": "1",
      "163": "1",
      "75": "1",
      "171": "1",
      "53": "1",
      "181": "1",
      "57": "1",
      "185": "1",
      "85": "1",
      "149": "1",
      "89": "1",
      "153": "1",
      "71": "1",
      "103": "1",
      "135": "1",
      "117": "1",
      "121": "1",
      "125": "-1",
      "113": "0"
    },
    "2": {
      "34": "1",
      "194": "1",
      "44": "1",
      "204": "1",
      "66": "1",
      "162": "1",
      "76": "1",
      "172": "1",
      "52": "1",
      "180": "1",
      "58": "1",
      "186": "1",
      "84": "1",
      "148": "1",
      "90": "1",
      "154": "1",
      "70": "1",
      "166": "1",
      "72": "1",
      "168": "1",
      "102": "1",
      "134": "1",
      "104": "1",
      "136": "1",
      "125": "-1",
      "113": "0"
    },
    "3": {
      "51": "1",
      "179": "1",
      "59": "1",
      "187": "1",
      "83": "1",
      "147": "1",
      "91": "1",
      "155": "1",
      "69": "1",
      "165": "1",
      "73": "1",
      "169": "1",
      "101": "1",
      "133": "1",
      "105": "1",
      "137": "1",
      "87": "1",
      "119": "1",
      "151": "1",
      "125": "-1",
      "113": "0"
    },
    "4": {
      "68": "1",
      "164": "1",
      "74": "1",
      "170": "1",
      "100": "1",
      "132": "1",
      "106": "1",
      "138": "1",
      "86": "1",
      "150": "1",
      "88": "1",
      "152": "1",
      "118": "1",
      "120": "1",
      "125": "-1",
      "113": "0"
    },
    "5": {
      "85": "1",
      "117": "1",
      "89": "1",
      "121": "1",
      "149": "1",
      "153": "1",
      "103": "1",
      "135": "1",
      "125": "-1",
      "113": "0"
    },
    "6": {
      "119": "1",
      "133": "1",
      "105": "1",
      "101": "1",
      "125": "-1",
      "113": "0",
      "137": "1"
    }
  },
  "TileItemArray": [],
  "TotalItemNum": 14,
  "MoveVect": [
    0.0,
    0.0
  ],
  "TileTotalNum": 0,
  "TileLevelHardType": "Normal",
  "TotalCount": 111
}