{
  "AllLayerTileDict": {
    "1": {
      "20": "1",
      "22": "1",
      "24": "1",
      "26": "1",
      "51": "1",
      "53": "1",
      "55": "1",
      "57": "1",
      "59": "1",
      "125": "1",
      "92": "1",
      "90": "1",
      "88": "1",
      "86": "1",
      "84": "1",
      "82": "1",
      "113": "1",
      "123": "1",
      "212": "1",
      "181": "1",
      "152": "1",
      "179": "1",
      "154": "1",
      "156": "1",
      "115": "1",
      "117": "1",
      "119": "1",
      "121": "1",
      "187": "1",
      "185": "1",
      "183": "1",
      "148": "1",
      "150": "1",
      "146": "1",
      "214": "1",
      "216": "1",
      "218": "1",
      "17": "-2",
      "29": "-2",
      "209": "-3",
      "221": "-3"
    },
    "2": {
      "101": "1",
      "74": "1",
      "198": "1",
      "72": "1",
      "196": "1",
      "105": "1",
      "103": "1",
      "68": "1",
      "169": "1",
      "41": "1",
      "163": "1",
      "138": "1",
      "107": "1",
      "39": "1",
      "165": "1",
      "99": "1",
      "136": "1",
      "130": "1",
      "70": "1",
      "171": "1",
      "134": "1",
      "132": "1",
      "140": "1",
      "37": "1",
      "167": "1",
      "200": "1",
      "202": "1",
      "17": "-2",
      "29": "-2",
      "209": "-3",
      "221": "-3"
    },
    "3": {
      "87": "1",
      "54": "1",
      "56": "1",
      "85": "1",
      "116": "1",
      "118": "1",
      "120": "1",
      "122": "1",
      "89": "1",
      "147": "1",
      "149": "1",
      "151": "1",
      "153": "1",
      "155": "1",
      "180": "1",
      "182": "1",
      "184": "1",
      "186": "1",
      "17": "-2",
      "29": "-2",
      "209": "-3",
      "221": "-3"
    },
    "4": {
      "71": "1",
      "102": "1",
      "104": "1",
      "133": "1",
      "135": "1",
      "137": "1",
      "164": "1",
      "166": "1",
      "168": "1",
      "170": "1",
      "17": "-2",
      "29": "-2",
      "209": "-3",
      "221": "-3"
    },
    "5": {
      "87": "1",
      "118": "1",
      "120": "1",
      "149": "1",
      "151": "1",
      "153": "1",
      "17": "-2",
      "29": "-2",
      "209": "-3",
      "221": "-3"
    },
    "6": {
      "103": "1",
      "133": "1",
      "137": "1",
      "135": "1",
      "17": "-2",
      "29": "-2",
      "209": "-3",
      "221": "-3"
    }
  },
  "TileItemArray": [],
  "TotalItemNum": 14,
  "MoveVect": [
    0.0,
    0.0
  ],
  "TileTotalNum": 0,
  "TileLevelHardType": "Normal",
  "TotalCount": 126
}