{
  "AllLayerTileDict": {
    "1": {
      "113": "1",
      "125": "1",
      "83": "1",
      "91": "1",
      "115": "1",
      "123": "1",
      "147": "1",
      "155": "1",
      "53": "1",
      "57": "1",
      "85": "1",
      "89": "1",
      "117": "1",
      "121": "1",
      "149": "1",
      "153": "1",
      "181": "1",
      "185": "1",
      "23": "1",
      "55": "1",
      "87": "1",
      "119": "1",
      "151": "1",
      "183": "1",
      "215": "1",
      "28": "-1",
      "220": "-1",
      "18": "0",
      "210": "0"
    },
    "2": {
      "114": "1",
      "124": "1",
      "102": "1",
      "104": "1",
      "100": "1",
      "106": "1",
      "132": "1",
      "138": "1",
      "70": "1",
      "72": "1",
      "166": "1",
      "168": "1",
      "134": "1",
      "136": "1",
      "199": "1",
      "39": "1",
      "28": "-1",
      "220": "-1",
      "18": "0",
      "210": "0"
    },
    "3": {
      "115": "1",
      "123": "1",
      "101": "1",
      "105": "1",
      "55": "1",
      "87": "1",
      "119": "1",
      "151": "1",
      "183": "1",
      "133": "1",
      "137": "1",
      "28": "-1",
      "220": "-1",
      "18": "0",
      "210": "0"
    },
    "4": {
      "134": "1",
      "122": "1",
      "102": "1",
      "116": "1",
      "104": "1",
      "136": "1",
      "71": "1",
      "167": "1",
      "28": "-1",
      "220": "-1",
      "18": "0",
      "210": "0"
    },
    "5": {
      "87": "1",
      "117": "1",
      "119": "1",
      "121": "1",
      "151": "1"
    },
    "6": {
      "103": "1",
      "135": "1",
      "101": "1",
      "133": "1",
      "105": "1",
      "137": "1",
      "167": "1",
      "71": "1"
    },
    "7": {
      "55": "1",
      "87": "1",
      "119": "1",
      "151": "1",
      "183": "1",
      "117": "1",
      "121": "1",
      "85": "1",
      "89": "1",
      "149": "1",
      "153": "1",
      "99": "1",
      "131": "1",
      "107": "1",
      "139": "1"
    },
    "8": {
      "39": "1",
      "71": "1",
      "167": "1",
      "103": "1",
      "135": "1",
      "69": "1",
      "101": "1",
      "133": "1",
      "165": "1",
      "73": "1",
      "105": "1",
      "137": "1",
      "169": "1",
      "83": "1",
      "91": "1",
      "115": "1",
      "123": "1",
      "147": "1",
      "155": "1"
    }
  },
  "TileItemArray": [],
  "TotalItemNum": 13,
  "MoveVect": [
    0.0,
    0.0
  ],
  "TileTotalNum": 0,
  "TileLevelHardType": "Normal",
  "TotalCount": 123
}