{
  "AllLayerTileDict": {
    "1": {
      "23": 1,
      "215": 1,
      "21": 1,
      "213": 1,
      "25": 1,
      "217": 1,
      "53": 1,
      "181": 1,
      "55": 1,
      "183": 1,
      "57": 1,
      "185": 1,
      "85": 1,
      "87": 1,
      "89": 1,
      "117": 1,
      "119": 1,
      "121": 1,
      "149": 1,
      "151": 1,
      "153": 1,
      "123": 1,
      "115": 1,
      "91": 1,
      "83": 1,
      "155": 1,
      "147": 1,
      "93": 1,
      "81": 1,
      "125": 1,
      "113": 1,
      "157": 1,
      "145": 1
    },
    "2": {
      "38": 1,
      "40": 1,
      "70": 1,
      "102": 1,
      "134": 1,
      "166": 1,
      "198": 1,
      "200": 1,
      "168": 1,
      "136": 1,
      "104": 1,
      "72": 1,
      "98": 1,
      "100": 1,
      "130": 1,
      "132": 1,
      "106": 1,
      "108": 1,
      "138": 1,
      "140": 1
    },
    "3": {
      "55": 1,
      "87": 1,
      "119": 1,
      "151": 1,
      "183": 1,
      "117": 1,
      "115": 1,
      "121": 1,
      "123": 1
    },
    "4": {
      "102": 1,
      "104": 1,
      "134": 1,
      "136": 1,
      "132": 1,
      "138": 1,
      "98": 1,
      "108": 1,
      "100": 1,
      "106": 1,
      "130": 1,
      "140": 1,
      "70": 1,
      "166": 1,
      "72": 1,
      "168": 1,
      "38": 1,
      "198": 1,
      "40": 1,
      "200": 1
    },
    "5": {
      "21": 1,
      "213": 1,
      "23": 1,
      "215": 1,
      "25": 1,
      "217": 1,
      "53": 1,
      "181": 1,
      "55": 1,
      "183": 1,
      "57": 1,
      "185": 1,
      "85": 1,
      "149": 1,
      "87": 1,
      "151": 1,
      "89": 1,
      "153": 1,
      "117": 1,
      "119": 1,
      "121": 1,
      "91": 1,
      "83": 1,
      "123": 1,
      "115": 1,
      "155": 1,
      "147": 1,
      "93": 1,
      "81": 1,
      "125": 1,
      "113": 1,
      "157": 1,
      "145": 1
    },
    "6": {
      "38": 1,
      "40": 1,
      "70": 1,
      "72": 1,
      "102": 1,
      "104": 1,
      "136": 1,
      "168": 1,
      "200": 1,
      "134": 1,
      "166": 1,
      "198": 1,
      "100": 1,
      "106": 1,
      "132": 1,
      "138": 1,
      "98": 1,
      "108": 1,
      "130": 1,
      "140": 1
    },
    "7": {
      "55": 1,
      "87": 1,
      "119": 1,
      "151": 1,
      "183": 1,
      "115": 1,
      "117": 1,
      "121": 1,
      "123": 1
    }
  },
  "TileItemArray": [],
  "TotalItemNum": 15,
  "MoveVect": [
    0.0,
    0.0
  ],
  "TileTotalNum": 0,
  "TileLevelHardType": "Normal",
  "TotalCount": 144
}