{
  "AllLayerTileDict": {
    "1": {
      "17": "1",
      "29": "1",
      "49": "1",
      "61": "1",
      "81": "1",
      "93": "1",
      "113": "1",
      "125": "1",
      "145": "1",
      "157": "1",
      "177": "1",
      "189": "1",
      "209": "1",
      "221": "1",
      "51": "1",
      "59": "1",
      "83": "1",
      "91": "1",
      "115": "1",
      "123": "1",
      "147": "1",
      "155": "1",
      "179": "1",
      "187": "1",
      "85": "1",
      "89": "1",
      "117": "1",
      "121": "1",
      "149": "1",
      "153": "1",
      "119": "1",
      "22": "-2",
      "24": "-2",
      "214": "-3",
      "216": "-3"
    },
    "2": {
      "34": "1",
      "44": "1",
      "66": "1",
      "76": "1",
      "98": "1",
      "108": "1",
      "130": "1",
      "140": "1",
      "162": "1",
      "172": "1",
      "194": "1",
      "204": "1",
      "68": "1",
      "74": "1",
      "100": "1",
      "106": "1",
      "132": "1",
      "138": "1",
      "164": "1",
      "170": "1",
      "118": "1",
      "120": "1",
      "22": "-2",
      "24": "-2",
      "214": "-3",
      "216": "-3"
    },
    "3": {
      "51": "1",
      "59": "1",
      "83": "1",
      "91": "1",
      "115": "1",
      "123": "1",
      "147": "1",
      "155": "1",
      "179": "1",
      "187": "1",
      "101": "1",
      "105": "1",
      "133": "1",
      "137": "1",
      "119": "1",
      "22": "-2",
      "24": "-2",
      "214": "-3",
      "216": "-3"
    },
    "4": {
      "68": "1",
      "74": "1",
      "100": "1",
      "106": "1",
      "118": "1",
      "138": "1",
      "164": "1",
      "170": "1",
      "22": "-2",
      "132": "1",
      "120": "1",
      "24": "-2",
      "214": "-3",
      "216": "-3"
    },
    "5": {
      "85": "1",
      "89": "1",
      "117": "1",
      "121": "1",
      "149": "1",
      "153": "1",
      "119": "1",
      "22": "-2",
      "24": "-2",
      "214": "-3",
      "216": "-3"
    },
    "6": {
      "104": "1",
      "84": "1",
      "102": "1",
      "134": "1",
      "22": "-2",
      "24": "-2",
      "214": "-3",
      "216": "-3",
      "148": "1",
      "154": "1",
      "136": "1",
      "90": "1"
    }
  },
  "TileItemArray": [],
  "TotalItemNum": 11,
  "MoveVect": [
    0.0,
    0.0
  ],
  "TileTotalNum": 0,
  "TileLevelHardType": "Hard",
  "TotalCount": 117
}