{
  "AllLayerTileDict": {
    "1": {
      "23": "1",
      "55": "1",
      "87": "1",
      "118": "1",
      "120": "1",
      "148": "1",
      "154": "1",
      "179": "1",
      "187": "1",
      "209": "1",
      "221": "1",
      "150": "1",
      "152": "1",
      "181": "1",
      "183": "1",
      "185": "1",
      "211": "1",
      "213": "1",
      "215": "1",
      "217": "1",
      "219": "1",
      "18": "0",
      "50": "0",
      "82": "0",
      "113": "0",
      "28": "-1",
      "60": "-1",
      "92": "-1",
      "125": "-1"
    },
    "2": {
      "113": "0",
      "82": "0",
      "50": "0",
      "164": "1",
      "166": "1",
      "168": "1",
      "170": "1",
      "28": "-1",
      "204": "1",
      "137": "1",
      "133": "1",
      "135": "1",
      "198": "1",
      "202": "1",
      "103": "1",
      "71": "1",
      "18": "0",
      "200": "1",
      "39": "1",
      "196": "1",
      "194": "1",
      "60": "-1",
      "92": "-1",
      "125": "-1"
    },
    "3": {
      "179": "1",
      "181": "1",
      "183": "1",
      "185": "1",
      "187": "1",
      "149": "1",
      "151": "1",
      "153": "1",
      "118": "1",
      "120": "1",
      "87": "1",
      "55": "1",
      "18": "0",
      "50": "0",
      "82": "0",
      "113": "0",
      "28": "-1",
      "60": "-1",
      "92": "-1",
      "125": "-1"
    },
    "4": {
      "164": "1",
      "166": "1",
      "168": "1",
      "170": "1",
      "134": "1",
      "136": "1",
      "103": "1",
      "71": "1",
      "18": "0",
      "50": "0",
      "82": "0",
      "113": "0",
      "28": "-1",
      "60": "-1",
      "92": "-1",
      "125": "-1"
    },
    "5": {
      "149": "1",
      "151": "1",
      "153": "1",
      "119": "1",
      "87": "1",
      "18": "0",
      "50": "0",
      "82": "0",
      "113": "0",
      "28": "-1",
      "60": "-1",
      "92": "-1",
      "125": "-1"
    },
    "6": {
      "134": "1",
      "136": "1",
      "103": "1",
      "18": "0",
      "50": "0",
      "82": "0",
      "113": "0",
      "28": "-1",
      "60": "-1",
      "92": "-1",
      "125": "-1",
      "71": "1"
    }
  },
  "TileItemArray": [],
  "TotalItemNum": 11,
  "MoveVect": [
    0.0,
    0.0
  ],
  "TileTotalNum": 0,
  "TileLevelHardType": "Normal",
  "TotalCount": 114
}