{
  "AllLayerTileDict": {
    "1": {
      "113": "1",
      "115": "1",
      "117": "1",
      "119": "1",
      "121": "1",
      "123": "1",
      "125": "1",
      "24": "1",
      "216": "1",
      "22": "1",
      "214": "1",
      "57": "1",
      "185": "1",
      "55": "1",
      "183": "1",
      "53": "1",
      "181": "1",
      "83": "1",
      "147": "1",
      "85": "1",
      "149": "1",
      "87": "1",
      "151": "1",
      "89": "1",
      "153": "1",
      "91": "1",
      "155": "1"
    },
    "2": {
      "84": "1",
      "148": "1",
      "120": "1",
      "114": "1",
      "23": "1",
      "215": "1",
      "54": "1",
      "182": "1",
      "124": "1",
      "118": "1",
      "90": "1",
      "154": "1",
      "56": "1",
      "184": "1",
      "122": "1",
      "88": "1",
      "152": "1",
      "86": "1",
      "150": "1",
      "116": "1"
    },
    "3": {
      "87": "1",
      "85": "1",
      "89": "1",
      "115": "1",
      "55": "1",
      "123": "1",
      "183": "1",
      "149": "1",
      "153": "1",
      "151": "1",
      "121": "1",
      "117": "1",
      "119": "1"
    },
    "4": {
      "116": "1",
      "118": "1",
      "86": "1",
      "39": "1",
      "88": "1",
      "122": "1",
      "152": "1",
      "120": "1",
      "199": "1",
      "150": "1"
    },
    "5": {
      "115": "1",
      "123": "1",
      "53": "1",
      "181": "1",
      "55": "1",
      "183": "1",
      "83": "1",
      "91": "1",
      "147": "1",
      "155": "1",
      "51": "1",
      "59": "1",
      "179": "1",
      "187": "1",
      "57": "1",
      "185": "1",
      "117": "1",
      "119": "1",
      "121": "1",
      "87": "1",
      "151": "1"
    },
    "6": {
      "170": "1",
      "168": "1",
      "166": "1",
      "138": "1",
      "106": "1",
      "68": "1",
      "70": "1",
      "72": "1",
      "74": "1",
      "132": "1",
      "118": "1",
      "120": "1",
      "164": "1",
      "100": "1"
    },
    "7": {
      "85": "1",
      "117": "1",
      "149": "1",
      "151": "1",
      "153": "1",
      "121": "1",
      "89": "1",
      "87": "1",
      "119": "1"
    },
    "8": {
      "102": "1",
      "134": "1",
      "136": "1",
      "104": "1"
    },
    "9": {
      "146": "1",
      "156": "1",
      "82": "1",
      "92": "1",
      "196": "1",
      "202": "1",
      "36": "1",
      "42": "1",
      "119": "1",
      "215": "1",
      "23": "1"
    }
  },
  "TileItemArray": [],
  "TotalItemNum": 13,
  "MoveVect": [
    0.0,
    0.0
  ],
  "TileTotalNum": 0,
  "TileLevelHardType": "Normal",
  "TotalCount": 129
}