{
  "AllLayerTileDict": {
    "1": {
      "209": "1",
      "211": "1",
      "213": "1",
      "215": "1",
      "217": "1",
      "219": "1",
      "221": "1",
      "177": "1",
      "179": "1",
      "181": "1",
      "183": "1",
      "185": "1",
      "187": "1",
      "189": "1",
      "145": "1",
      "147": "1",
      "149": "1",
      "151": "1",
      "153": "1",
      "155": "1",
      "157": "1",
      "113": "1",
      "115": "1",
      "117": "1",
      "119": "1",
      "121": "1",
      "123": "1",
      "125": "1",
      "85": "1",
      "87": "1",
      "89": "1",
      "53": "1",
      "55": "1",
      "57": "1",
      "21": "1",
      "23": "1",
      "25": "1",
      "18": "-1",
      "66": "-1",
      "28": "0",
      "76": "0"
    },
    "2": {
      "194": "1",
      "196": "1",
      "198": "1",
      "200": "1",
      "202": "1",
      "204": "1",
      "172": "1",
      "170": "1",
      "168": "1",
      "166": "1",
      "164": "1",
      "162": "1",
      "130": "1",
      "132": "1",
      "134": "1",
      "136": "1",
      "138": "1",
      "140": "1",
      "101": "1",
      "103": "1",
      "105": "1",
      "69": "1",
      "71": "1",
      "73": "1",
      "37": "1",
      "39": "1",
      "41": "1",
      "18": "-1",
      "66": "-1",
      "28": "0",
      "76": "0"
    },
    "3": {
      "179": "1",
      "147": "1",
      "181": "1",
      "183": "1",
      "185": "1",
      "187": "1",
      "155": "1",
      "153": "1",
      "151": "1",
      "149": "1",
      "117": "1",
      "119": "1",
      "121": "1",
      "85": "1",
      "87": "1",
      "89": "1",
      "53": "1",
      "55": "1",
      "57": "1",
      "18": "-1",
      "66": "-1",
      "28": "0",
      "76": "0"
    },
    "4": {
      "164": "1",
      "166": "1",
      "168": "1",
      "170": "1",
      "133": "1",
      "135": "1",
      "137": "1",
      "101": "1",
      "103": "1",
      "105": "1",
      "69": "1",
      "71": "1",
      "73": "1",
      "18": "-1",
      "66": "-1",
      "28": "0",
      "76": "0"
    },
    "5": {
      "149": "1",
      "151": "1",
      "153": "1",
      "117": "1",
      "119": "1",
      "121": "1",
      "85": "1",
      "87": "1",
      "89": "1",
      "18": "-1",
      "66": "-1",
      "28": "0",
      "76": "0"
    },
    "6": {
      "133": "1",
      "135": "1",
      "137": "1",
      "101": "1",
      "103": "1",
      "105": "1",
      "18": "-1",
      "66": "-1",
      "28": "0",
      "76": "0"
    },
    "7": {
      "120": "1",
      "118": "1",
      "18": "-1",
      "66": "-1",
      "28": "0",
      "76": "0"
    }
  },
  "TileItemArray": [],
  "TotalItemNum": 15,
  "MoveVect": [
    0.0,
    0.0
  ],
  "TileTotalNum": 0,
  "TileLevelHardType": "Normal",
  "TotalCount": 141
}