{
  "AllLayerTileDict": {
    "1": {
      "23": "1",
      "55": "1",
      "87": "1",
      "119": "1",
      "151": "1",
      "183": "1",
      "17": "-2",
      "19": "-2",
      "29": "-2",
      "27": "-2"
    },
    "2": {
      "38": "1",
      "40": "1",
      "102": "1",
      "104": "1",
      "70": "1",
      "72": "1",
      "134": "1",
      "136": "1",
      "166": "1",
      "168": "1",
      "198": "1",
      "200": "1",
      "17": "-2",
      "19": "-2",
      "29": "-2",
      "27": "-2"
    },
    "3": {
      "117": "1",
      "121": "1",
      "85": "1",
      "89": "1",
      "53": "1",
      "57": "1",
      "149": "1",
      "153": "1",
      "181": "1",
      "185": "1",
      "213": "1",
      "217": "1",
      "17": "-2",
      "19": "-2",
      "29": "-2",
      "27": "-2"
    },
    "4": {
      "68": "1",
      "74": "1",
      "100": "1",
      "106": "1",
      "132": "1",
      "138": "1",
      "196": "1",
      "202": "1",
      "164": "1",
      "170": "1",
      "210": "1",
      "220": "1",
      "17": "-2",
      "19": "-2",
      "29": "-2",
      "27": "-2"
    },
    "5": {
      "83": "1",
      "91": "1",
      "115": "1",
      "123": "1",
      "147": "1",
      "155": "1",
      "179": "1",
      "187": "1",
      "193": "1",
      "205": "1",
      "17": "-2",
      "19": "-2",
      "29": "-2",
      "27": "-2"
    },
    "6": {
      "178": "1",
      "188": "1",
      "146": "1",
      "156": "1",
      "82": "1",
      "92": "1",
      "114": "1",
      "124": "1",
      "17": "-2",
      "19": "-2",
      "29": "-2",
      "27": "-2"
    }
  },
  "TileItemArray": [],
  "TotalItemNum": 10,
  "MoveVect": [
    0.0,
    0.0
  ],
  "TileTotalNum": 0,
  "TileLevelHardType": "Normal",
  "TotalCount": 84
}