{
  "AllLayerTileDict": {
    "1": {
      "29": "1",
      "61": "1",
      "93": "1",
      "125": "1",
      "157": "1",
      "189": "1",
      "221": "1",
      "219": "1",
      "217": "1",
      "215": "1",
      "213": "1",
      "211": "1",
      "209": "1",
      "177": "1",
      "145": "1",
      "68": "1",
      "70": "1",
      "27": "1",
      "25": "1",
      "56": "1",
      "131": "1",
      "34": "1",
      "100": "1"
    },
    "2": {
      "204": "1",
      "172": "1",
      "140": "1",
      "108": "1",
      "76": "1",
      "44": "1",
      "42": "1",
      "202": "1",
      "200": "1",
      "198": "1",
      "196": "1",
      "194": "1",
      "162": "1",
      "85": "1",
      "117": "1",
      "148": "1",
      "87": "1",
      "73": "1",
      "51": "1"
    },
    "3": {
      "187": "1",
      "155": "1",
      "123": "1",
      "91": "1",
      "59": "1",
      "185": "1",
      "183": "1",
      "181": "1",
      "179": "1",
      "147": "1",
      "57": "1",
      "102": "1",
      "68": "1",
      "133": "1",
      "88": "1"
    },
    "4": {
      "170": "1",
      "138": "1",
      "106": "1",
      "74": "1",
      "168": "1",
      "166": "1",
      "164": "1",
      "134": "1",
      "104": "1",
      "85": "1"
    },
    "5": {
      "149": "1",
      "151": "1",
      "153": "1",
      "121": "1",
      "89": "1",
      "102": "1"
    },
    "6": {
      "85": "1",
      "74": "1",
      "106": "1",
      "138": "1",
      "170": "1",
      "168": "1",
      "166": "1",
      "164": "1",
      "119": "1"
    },
    "7": {
      "59": "1",
      "91": "1",
      "123": "1",
      "155": "1",
      "187": "1",
      "185": "1",
      "183": "1",
      "181": "1",
      "179": "1",
      "136": "1",
      "102": "1"
    }
  },
  "TileItemArray": [],
  "TotalItemNum": 11,
  "MoveVect": [
    0.0,
    0.0
  ],
  "TileTotalNum": 0,
  "TileLevelHardType": "Normal",
  "TotalCount": 93
}