{
  "AllLayerTileDict": {
    "1": {
      "131": "-2",
      "69": "-2",
      "71": "-2",
      "73": "-2",
      "133": "-2",
      "135": "-2",
      "137": "-2",
      "139": "-2",
      "193": "-2",
      "195": "-2",
      "197": "-2",
      "199": "-2",
      "201": "-2",
      "203": "-2",
      "205": "-2",
      "18": "0",
      "28": "-1"
    },
    "2": {
      "69": "-2",
      "71": "-2",
      "73": "-2",
      "131": "-2",
      "133": "-2",
      "135": "-2",
      "137": "-2",
      "139": "-2",
      "193": "-2",
      "195": "-2",
      "197": "-2",
      "199": "-2",
      "201": "-2",
      "203": "-2",
      "205": "-2",
      "18": "0",
      "28": "-1"
    },
    "3": {
      "69": "-2",
      "71": "-2",
      "73": "-2",
      "131": "-2",
      "133": "-2",
      "135": "-2",
      "137": "-2",
      "139": "-2",
      "193": "-2",
      "195": "-2",
      "197": "-2",
      "199": "-2",
      "201": "-2",
      "203": "-2",
      "205": "-2",
      "18": "0",
      "28": "-1"
    },
    "4": {
      "69": "-2",
      "71": "-2",
      "73": "-2",
      "131": "-2",
      "133": "-2",
      "135": "-2",
      "137": "-2",
      "139": "-2",
      "193": "-2",
      "195": "-2",
      "197": "-2",
      "199": "-2",
      "201": "-2",
      "203": "-2",
      "205": "-2",
      "18": "0",
      "28": "-1"
    },
    "5": {
      "69": "-2",
      "71": "-2",
      "73": "-2",
      "131": "-2",
      "133": "-2",
      "135": "-2",
      "137": "-2",
      "139": "-2",
      "193": "-2",
      "195": "-2",
      "197": "-2",
      "199": "-2",
      "201": "-2",
      "203": "-2",
      "205": "-2",
      "18": "0",
      "28": "-1"
    },
    "6": {
      "69": "-2",
      "71": "-2",
      "73": "-2",
      "131": "-2",
      "133": "-2",
      "135": "-2",
      "137": "-2",
      "139": "-2",
      "193": "-2",
      "195": "-2",
      "197": "-2",
      "199": "-2",
      "201": "-2",
      "203": "-2",
      "205": "-2",
      "18": "0",
      "28": "-1"
    },
    "7": {
      "69": "-2",
      "71": "-2",
      "73": "-2",
      "131": "-2",
      "133": "-2",
      "135": "-2",
      "137": "-2",
      "139": "-2",
      "193": "-2",
      "195": "-2",
      "197": "-2",
      "199": "-2",
      "201": "-2",
      "203": "-2",
      "205": "-2",
      "18": "0",
      "28": "-1"
    },
    "8": {
      "69": "-2",
      "71": "-2",
      "73": "-2",
      "131": "-2",
      "133": "-2",
      "135": "-2",
      "137": "-2",
      "139": "-2",
      "193": "-2",
      "195": "-2",
      "197": "-2",
      "199": "-2",
      "201": "-2",
      "203": "-2",
      "205": "-2",
      "18": "0",
      "28": "-1"
    },
    "9": {
      "28": "-1",
      "18": "0"
    }
  },
  "TileItemArray": [],
  "TotalItemNum": 15,
  "MoveVect": [
    0.0,
    0.5
  ],
  "TileTotalNum": 0,
  "TileLevelHardType": "Normal",
  "TotalCount": 138
}