{
  "AllLayerTileDict": {
    "1": {
      "52": "1",
      "58": "1",
      "180": "1",
      "186": "1",
      "50": "1",
      "60": "1",
      "178": "1",
      "188": "1",
      "81": "1",
      "93": "1",
      "145": "1",
      "157": "1",
      "54": "1",
      "56": "1",
      "182": "1",
      "184": "1",
      "87": "1",
      "151": "1",
      "113": "1",
      "125": "1",
      "119": "1",
      "83": "1",
      "91": "1",
      "115": "1",
      "123": "1",
      "147": "1",
      "155": "1",
      "149": "1",
      "153": "1",
      "117": "1",
      "121": "1",
      "85": "1",
      "89": "1",
      "20": "1",
      "26": "1",
      "212": "1",
      "218": "1"
    },
    "2": {
      "36": "1",
      "196": "1",
      "42": "1",
      "202": "1",
      "67": "1",
      "69": "1",
      "71": "1",
      "73": "1",
      "75": "1",
      "98": "1",
      "100": "1",
      "102": "1",
      "104": "1",
      "106": "1",
      "108": "1",
      "130": "1",
      "132": "1",
      "134": "1",
      "136": "1",
      "138": "1",
      "140": "1",
      "163": "1",
      "165": "1",
      "167": "1",
      "169": "1",
      "171": "1"
    },
    "3": {
      "52": "1",
      "58": "1",
      "83": "1",
      "85": "1",
      "87": "1",
      "89": "1",
      "91": "1",
      "114": "1",
      "116": "1",
      "118": "1",
      "120": "1",
      "122": "1",
      "124": "1",
      "147": "1",
      "149": "1",
      "151": "1",
      "153": "1",
      "155": "1",
      "180": "1",
      "186": "1"
    },
    "4": {
      "68": "1",
      "74": "1",
      "99": "1",
      "101": "1",
      "103": "1",
      "105": "1",
      "107": "1",
      "131": "1",
      "133": "1",
      "135": "1",
      "137": "1",
      "139": "1",
      "164": "1",
      "170": "1"
    },
    "5": {
      "84": "1",
      "90": "1",
      "121": "1",
      "119": "1",
      "117": "1",
      "115": "1",
      "123": "1",
      "148": "1",
      "154": "1",
      "151": "1",
      "87": "1"
    },
    "6": {
      "99": "1",
      "101": "1",
      "103": "1",
      "105": "1",
      "107": "1",
      "131": "1",
      "133": "1",
      "135": "1",
      "137": "1",
      "139": "1",
      "68": "1",
      "74": "1",
      "164": "1",
      "170": "1"
    },
    "7": {
      "147": "1",
      "91": "1",
      "89": "1",
      "87": "1",
      "85": "1",
      "83": "1",
      "117": "1",
      "121": "1",
      "119": "1",
      "149": "1",
      "151": "1",
      "153": "1",
      "155": "1"
    }
  },
  "TileItemArray": [],
  "TotalItemNum": 14,
  "MoveVect": [
    0.0,
    0.0
  ],
  "TileTotalNum": 0,
  "TileLevelHardType": "Normal",
  "TotalCount": 135
}