{
  "AllLayerTileDict": {
    "1": {
      "50": "1",
      "60": "1",
      "82": "1",
      "92": "1",
      "114": "1",
      "124": "1",
      "146": "1",
      "156": "1",
      "178": "1",
      "188": "1"
    },
    "2": {
      "51": "1",
      "59": "1",
      "99": "1",
      "107": "1",
      "131": "1",
      "139": "1",
      "179": "1",
      "187": "1"
    },
    "3": {
      "68": "1",
      "74": "1",
      "116": "1",
      "122": "1",
      "164": "1",
      "170": "1"
    },
    "4": {
      "85": "1",
      "89": "1",
      "117": "1",
      "121": "1",
      "149": "1",
      "153": "1"
    },
    "5": {
      "70": "1",
      "72": "1",
      "104": "1",
      "136": "1",
      "168": "1",
      "166": "1",
      "134": "1",
      "102": "1",
      "68": "1",
      "100": "1",
      "132": "1",
      "164": "1",
      "74": "1",
      "106": "1",
      "138": "1",
      "170": "1"
    },
    "6": {
      "51": "1",
      "83": "1",
      "115": "1",
      "147": "1",
      "179": "1",
      "181": "1",
      "183": "1",
      "185": "1",
      "187": "1",
      "155": "1",
      "123": "1",
      "91": "1",
      "59": "1",
      "57": "1",
      "55": "1",
      "53": "1",
      "151": "1",
      "149": "1",
      "153": "1",
      "117": "1",
      "85": "1",
      "121": "1",
      "89": "1",
      "87": "1",
      "119": "1"
    },
    "7": {
      "34": "1",
      "66": "1",
      "98": "1",
      "130": "1",
      "162": "1",
      "194": "1",
      "196": "1",
      "198": "1",
      "200": "1",
      "202": "1",
      "204": "1",
      "172": "1",
      "140": "1",
      "108": "1",
      "76": "1",
      "44": "1",
      "42": "1",
      "40": "1",
      "38": "1",
      "36": "1",
      "68": "1",
      "100": "1",
      "132": "1",
      "164": "1",
      "166": "1",
      "168": "1",
      "170": "1",
      "138": "1",
      "106": "1",
      "74": "1",
      "72": "1",
      "70": "1",
      "102": "1",
      "104": "1",
      "136": "1",
      "134": "1"
    },
    "8": {
      "51": "1",
      "53": "1",
      "55": "1",
      "57": "1",
      "59": "1",
      "91": "1",
      "123": "1",
      "155": "1",
      "187": "1",
      "185": "1",
      "183": "1",
      "181": "1",
      "179": "1",
      "147": "1",
      "115": "1",
      "83": "1",
      "85": "1",
      "117": "1",
      "149": "1",
      "151": "1",
      "153": "1",
      "121": "1",
      "89": "1",
      "87": "1",
      "119": "1"
    }
  },
  "TileItemArray": [],
  "TotalItemNum": 12,
  "MoveVect": [
    0.0,
    0.0
  ],
  "TileTotalNum": 0,
  "TileLevelHardType": "Normal",
  "TotalCount": 132
}