{
  "AllLayerTileDict": {
    "1": {
      "23": "1",
      "37": "1",
      "41": "1",
      "51": "1",
      "59": "1",
      "65": "1",
      "77": "1",
      "55": "1",
      "69": "1",
      "73": "1",
      "83": "1",
      "91": "1",
      "87": "1",
      "101": "1",
      "105": "1",
      "119": "1"
    },
    "2": {
      "39": "1",
      "53": "1",
      "57": "1",
      "67": "1",
      "75": "1",
      "81": "1",
      "93": "1",
      "71": "1",
      "103": "1",
      "135": "1",
      "85": "1",
      "99": "1",
      "117": "1",
      "89": "1",
      "121": "1",
      "107": "1"
    },
    "3": {
      "55": "1",
      "69": "1",
      "73": "1",
      "83": "1",
      "91": "1",
      "97": "1",
      "109": "1",
      "87": "1",
      "119": "1",
      "151": "1",
      "101": "1",
      "133": "1",
      "115": "1",
      "105": "1",
      "137": "1",
      "123": "1"
    },
    "4": {
      "71": "1",
      "103": "1",
      "135": "1",
      "167": "1",
      "85": "1",
      "89": "1",
      "99": "1",
      "107": "1",
      "113": "1",
      "125": "1",
      "121": "1",
      "153": "1",
      "117": "1",
      "149": "1",
      "131": "1",
      "139": "1"
    },
    "5": {
      "87": "1",
      "119": "1",
      "151": "1",
      "183": "1",
      "101": "1",
      "115": "1",
      "129": "1",
      "105": "1",
      "123": "1",
      "141": "1",
      "133": "1",
      "165": "1",
      "137": "1",
      "169": "1",
      "147": "1",
      "155": "1"
    },
    "6": {
      "103": "1",
      "135": "1",
      "167": "1",
      "199": "1",
      "117": "1",
      "121": "1",
      "131": "1",
      "139": "1",
      "145": "1",
      "157": "1",
      "149": "1",
      "153": "1",
      "181": "1",
      "185": "1",
      "163": "1",
      "171": "1"
    },
    "7": {
      "119": "1",
      "151": "1",
      "183": "1",
      "215": "1",
      "133": "1",
      "137": "1",
      "165": "1",
      "169": "1",
      "197": "1",
      "201": "1",
      "147": "1",
      "155": "1",
      "179": "1",
      "187": "1",
      "161": "1",
      "173": "1"
    },
    "8": {
      "135": "1",
      "167": "1",
      "199": "1",
      "149": "1",
      "153": "1",
      "163": "1",
      "181": "1",
      "185": "1",
      "171": "1",
      "177": "1",
      "189": "1"
    }
  },
  "TileItemArray": [],
  "TotalItemNum": 14,
  "MoveVect": [
    0.0,
    0.0
  ],
  "TileTotalNum": 0,
  "TileLevelHardType": "Normal",
  "TotalCount": 123
}