{
  "AllLayerTileDict": {
    "1": {
      "74": "1",
      "104": "1",
      "134": "1",
      "164": "1",
      "136": "1",
      "102": "1",
      "68": "1",
      "170": "1"
    },
    "2": {
      "85": "1",
      "89": "1",
      "119": "1",
      "149": "1",
      "153": "1"
    },
    "3": {
      "34": "1",
      "44": "1",
      "68": "1",
      "102": "1",
      "136": "1",
      "170": "1",
      "204": "1",
      "194": "1",
      "134": "1",
      "104": "1",
      "74": "1",
      "164": "1"
    },
    "4": {
      "51": "1",
      "59": "1",
      "85": "1",
      "89": "1",
      "119": "1",
      "149": "1",
      "153": "1",
      "179": "1",
      "187": "1"
    },
    "5": {
      "68": "1",
      "164": "1",
      "74": "1",
      "170": "1",
      "34": "1",
      "194": "1",
      "44": "1",
      "204": "1",
      "102": "1",
      "134": "1",
      "104": "1",
      "136": "1"
    },
    "6": {
      "33": "1",
      "193": "1",
      "45": "1",
      "205": "1",
      "35": "1",
      "195": "1",
      "43": "1",
      "203": "1",
      "149": "1",
      "153": "1",
      "89": "1",
      "85": "1"
    },
    "7": {
      "50": "1",
      "178": "1",
      "60": "1",
      "188": "1",
      "132": "1",
      "138": "1",
      "100": "1",
      "106": "1",
      "103": "1",
      "135": "1"
    },
    "8": {
      "65": "1",
      "161": "1",
      "77": "1",
      "173": "1",
      "67": "1",
      "163": "1",
      "75": "1",
      "171": "1",
      "85": "1",
      "89": "1",
      "117": "1",
      "121": "1",
      "149": "1",
      "153": "1",
      "87": "1",
      "151": "1"
    },
    "9": {
      "82": "1",
      "146": "1",
      "92": "1",
      "156": "1",
      "102": "1",
      "104": "1",
      "134": "1",
      "136": "1"
    },
    "10": {
      "98": "1",
      "108": "1",
      "130": "1",
      "140": "1",
      "85": "1",
      "149": "1",
      "55": "1",
      "183": "1",
      "89": "1",
      "153": "1"
    },
    "11": {
      "113": "1",
      "125": "1",
      "115": "1",
      "123": "1",
      "137": "1",
      "166": "1",
      "168": "1",
      "133": "1",
      "72": "1",
      "70": "1",
      "101": "1",
      "105": "1"
    }
  },
  "GoldTileCount": 0,
  "TileItemArray": [],
  "TotalItemNum": 13,
  "MoveVect": [
    0.0,
    0.0
  ],
  "TileTotalNum": 0,
  "TileLevelHardType": "Normal",
  "TotalCount": 114
}