{
  "AllLayerTileDict": {
    "1": {
      "209": "1",
      "179": "1",
      "211": "1",
      "213": "1",
      "215": "1",
      "217": "1",
      "219": "1",
      "221": "1",
      "189": "1",
      "157": "1",
      "125": "1",
      "93": "1",
      "61": "1",
      "29": "1",
      "59": "1",
      "91": "1",
      "123": "1",
      "155": "1",
      "187": "1",
      "185": "1",
      "153": "1",
      "121": "1",
      "89": "1",
      "119": "1",
      "151": "1",
      "183": "1",
      "181": "1",
      "149": "1"
    },
    "2": {
      "193": "1",
      "136": "1",
      "72": "1",
      "132": "1",
      "196": "1",
      "200": "1",
      "28": "1",
      "140": "1",
      "76": "1",
      "204": "1"
    },
    "3": {
      "181": "1",
      "151": "1",
      "185": "1",
      "155": "1",
      "121": "1",
      "91": "1",
      "27": "1",
      "55": "1",
      "115": "1",
      "177": "1",
      "187": "1"
    },
    "4": {
      "161": "1",
      "98": "1",
      "38": "1",
      "26": "1",
      "106": "1",
      "136": "1",
      "166": "1",
      "170": "1"
    },
    "5": {
      "145": "1",
      "81": "1",
      "21": "1",
      "25": "1",
      "91": "1",
      "123": "1",
      "121": "1",
      "153": "1",
      "155": "1",
      "151": "1",
      "187": "1",
      "185": "1",
      "183": "1",
      "181": "1"
    },
    "6": {
      "24": "1",
      "20": "1",
      "129": "1",
      "65": "1",
      "76": "1",
      "108": "1",
      "140": "1",
      "172": "1",
      "204": "1",
      "202": "1",
      "200": "1",
      "198": "1",
      "196": "1",
      "74": "1",
      "106": "1",
      "138": "1",
      "170": "1",
      "168": "1",
      "166": "1",
      "164": "1"
    },
    "7": {
      "91": "1",
      "123": "1",
      "155": "1",
      "187": "1",
      "185": "1",
      "183": "1",
      "181": "1",
      "23": "1",
      "19": "1",
      "49": "1",
      "113": "1"
    },
    "8": {
      "76": "1",
      "108": "1",
      "140": "1",
      "172": "1",
      "204": "1",
      "202": "1",
      "200": "1",
      "198": "1",
      "196": "1",
      "22": "1",
      "34": "1",
      "97": "1"
    },
    "9": {
      "21": "1",
      "81": "1",
      "51": "1"
    }
  },
  "TileItemArray": [],
  "TotalItemNum": 11,
  "MoveVect": [
    0.0,
    0.0
  ],
  "TileTotalNum": 0,
  "TileLevelHardType": "Normal",
  "TotalCount": 117
}