{
  "AllLayerTileDict": {
    "1": {
      "17": "1",
      "49": "1",
      "145": "1",
      "113": "1",
      "81": "1",
      "177": "1",
      "209": "1",
      "51": "1",
      "83": "1",
      "115": "1",
      "147": "1",
      "179": "1",
      "211": "1"
    },
    "2": {
      "18": "1",
      "50": "1",
      "82": "1",
      "114": "1",
      "146": "1",
      "178": "1",
      "210": "1",
      "52": "1",
      "84": "1",
      "116": "1",
      "148": "1",
      "180": "1",
      "212": "1"
    },
    "3": {
      "35": "1",
      "195": "1",
      "163": "1",
      "131": "1",
      "99": "1",
      "67": "1",
      "101": "1",
      "133": "1",
      "165": "1",
      "197": "1"
    },
    "4": {
      "36": "1",
      "68": "1",
      "100": "1",
      "132": "1",
      "164": "1",
      "196": "1",
      "102": "1",
      "134": "1",
      "166": "1",
      "198": "1"
    },
    "5": {
      "53": "1",
      "85": "1",
      "117": "1",
      "149": "1",
      "181": "1",
      "151": "1",
      "183": "1"
    },
    "6": {
      "54": "1",
      "86": "1",
      "118": "1",
      "150": "1",
      "182": "1",
      "152": "1",
      "184": "1"
    },
    "7": {
      "71": "1",
      "103": "1",
      "135": "1",
      "167": "1",
      "169": "1"
    },
    "8": {
      "72": "1",
      "104": "1",
      "136": "1",
      "168": "1",
      "170": "1"
    },
    "9": {
      "57": "1",
      "89": "1",
      "121": "1",
      "153": "1",
      "185": "1",
      "183": "1",
      "187": "1"
    },
    "10": {
      "40": "1",
      "72": "1",
      "104": "1",
      "136": "1",
      "168": "1",
      "166": "1",
      "198": "1",
      "200": "1",
      "202": "1",
      "204": "1",
      "42": "1",
      "74": "1",
      "106": "1",
      "138": "1",
      "170": "1",
      "172": "1"
    },
    "11": {
      "23": "1",
      "25": "1",
      "27": "1",
      "59": "1",
      "91": "1",
      "123": "1",
      "155": "1",
      "157": "1",
      "189": "1",
      "221": "1",
      "219": "1",
      "55": "1",
      "87": "1",
      "119": "1",
      "151": "1",
      "181": "1",
      "149": "1",
      "213": "1",
      "215": "1",
      "217": "1",
      "153": "1"
    },
    "12": {
      "6": "1",
      "38": "1",
      "70": "1",
      "102": "1",
      "134": "1",
      "132": "1",
      "164": "1",
      "196": "1",
      "228": "1",
      "230": "1",
      "232": "1",
      "234": "1",
      "236": "1",
      "238": "1",
      "8": "1",
      "12": "1",
      "10": "1",
      "44": "1",
      "76": "1",
      "108": "1",
      "140": "1",
      "142": "1",
      "174": "1",
      "206": "1",
      "137": "1"
    },
    "13": {
      "121": "1"
    },
    "14": {
      "105": "1"
    }
  },
  "TileItemArray": [],
  "TotalItemNum": 10,
  "MoveVect": [
    -0.5,
    0.0
  ],
  "TileTotalNum": 0,
  "TileLevelHardType": "Normal",
  "TotalCount": 141
}