{
  "AllLayerTileDict": {
    "1": {
      "81": "1",
      "23": "-2",
      "27": "-2",
      "29": "-2",
      "25": "-2",
      "21": "-2",
      "19": "-2",
      "17": "-2"
    },
    "2": {
      "82": "1",
      "23": "-2",
      "27": "-2",
      "29": "-2",
      "25": "-2",
      "21": "-2",
      "19": "-2",
      "17": "-2"
    },
    "3": {
      "83": "1",
      "97": "1",
      "23": "-2",
      "27": "-2",
      "29": "-2",
      "25": "-2",
      "21": "-2",
      "19": "-2",
      "17": "-2"
    },
    "4": {
      "23": "-2",
      "98": "1",
      "84": "1",
      "27": "-2",
      "29": "-2",
      "25": "-2",
      "21": "-2",
      "19": "-2",
      "17": "-2"
    },
    "5": {
      "113": "1",
      "99": "1",
      "85": "1",
      "23": "-2",
      "27": "-2",
      "29": "-2",
      "25": "-2",
      "21": "-2",
      "19": "-2",
      "17": "-2"
    },
    "6": {
      "114": "1",
      "100": "1",
      "86": "1",
      "23": "-2",
      "27": "-2",
      "29": "-2",
      "25": "-2",
      "21": "-2",
      "19": "-2",
      "17": "-2"
    },
    "7": {
      "87": "1",
      "115": "1",
      "101": "1",
      "129": "1",
      "23": "-2",
      "27": "-2",
      "29": "-2",
      "25": "-2",
      "21": "-2",
      "19": "-2",
      "17": "-2"
    },
    "8": {
      "88": "1",
      "102": "1",
      "116": "1",
      "130": "1",
      "23": "-2",
      "27": "-2",
      "29": "-2",
      "25": "-2",
      "21": "-2",
      "19": "-2",
      "17": "-2"
    },
    "9": {
      "89": "1",
      "103": "1",
      "117": "1",
      "131": "1",
      "145": "1",
      "23": "-2",
      "27": "-2",
      "29": "-2",
      "25": "-2",
      "21": "-2",
      "19": "-2",
      "17": "-2"
    },
    "10": {
      "90": "1",
      "104": "1",
      "118": "1",
      "132": "1",
      "146": "1",
      "23": "-2",
      "27": "-2",
      "29": "-2",
      "25": "-2",
      "21": "-2",
      "19": "-2",
      "17": "-2"
    },
    "11": {
      "91": "1",
      "105": "1",
      "119": "1",
      "133": "1",
      "147": "1",
      "161": "1",
      "23": "-2",
      "27": "-2",
      "29": "-2",
      "25": "-2",
      "21": "-2",
      "17": "-2",
      "19": "-2"
    },
    "12": {
      "92": "1",
      "106": "1",
      "120": "1",
      "134": "1",
      "148": "1",
      "162": "1"
    },
    "13": {
      "93": "1",
      "107": "1",
      "121": "1",
      "135": "1",
      "149": "1",
      "163": "1",
      "177": "1"
    },
    "14": {
      "109": "1",
      "123": "1",
      "137": "1",
      "151": "1",
      "165": "1",
      "179": "1",
      "193": "1"
    },
    "15": {
      "125": "1",
      "139": "1",
      "153": "1",
      "167": "1",
      "181": "1",
      "195": "1",
      "209": "1"
    },
    "16": {
      "141": "1",
      "155": "1",
      "169": "1",
      "183": "1",
      "197": "1",
      "211": "1",
      "225": "1"
    }
  },
  "TileItemArray": [],
  "TotalItemNum": 12,
  "MoveVect": [
    0.0,
    -0.5
  ],
  "TileTotalNum": 0,
  "TileLevelHardType": "Normal",
  "TotalCount": 147
}