{
  "AllLayerTileDict": {
    "1": {
      "193": "1",
      "205": "1",
      "33": "1",
      "45": "1",
      "113": "1",
      "125": "1",
      "35": "1",
      "43": "1",
      "115": "1",
      "123": "1",
      "151": "1",
      "119": "1",
      "87": "1",
      "55": "1",
      "23": "1",
      "195": "1",
      "203": "1",
      "183": "1",
      "215": "1"
    },
    "2": {
      "51": "1",
      "59": "1",
      "49": "1",
      "61": "1",
      "179": "1",
      "187": "1",
      "177": "1",
      "189": "1",
      "114": "1",
      "124": "1",
      "39": "1",
      "103": "1",
      "199": "1",
      "135": "1"
    },
    "3": {
      "99": "1",
      "107": "1",
      "131": "1",
      "139": "1",
      "129": "1",
      "141": "1",
      "97": "1",
      "109": "1",
      "65": "1",
      "77": "1",
      "161": "1",
      "173": "1",
      "67": "1",
      "75": "1",
      "163": "1",
      "171": "1",
      "54": "1",
      "182": "1",
      "56": "1",
      "184": "1",
      "86": "1",
      "150": "1",
      "88": "1",
      "152": "1",
      "118": "1",
      "120": "1"
    },
    "4": {
      "113": "1",
      "125": "1",
      "115": "1",
      "123": "1",
      "83": "1",
      "91": "1",
      "81": "1",
      "93": "1",
      "145": "1",
      "157": "1",
      "147": "1",
      "155": "1",
      "102": "1",
      "72": "1",
      "70": "1",
      "104": "1",
      "134": "1",
      "136": "1",
      "166": "1",
      "168": "1"
    },
    "5": {
      "131": "1",
      "139": "1",
      "129": "1",
      "141": "1",
      "99": "1",
      "107": "1",
      "97": "1",
      "109": "1",
      "86": "1",
      "88": "1",
      "118": "1",
      "120": "1",
      "150": "1",
      "152": "1"
    },
    "6": {
      "178": "1",
      "188": "1",
      "146": "1",
      "156": "1",
      "114": "1",
      "124": "1",
      "82": "1",
      "92": "1",
      "50": "1",
      "60": "1",
      "102": "1",
      "104": "1",
      "134": "1",
      "136": "1",
      "71": "1",
      "39": "1",
      "167": "1",
      "199": "1"
    }
  },
  "TileItemArray": [],
  "TotalItemNum": 12,
  "MoveVect": [
    0.0,
    0.0
  ],
  "TileTotalNum": 0,
  "TileLevelHardType": "Normal",
  "TotalCount": 111
}