{
  "AllLayerTileDict": {
    "1": {
      "194": "1",
      "164": "1",
      "134": "1",
      "104": "1",
      "74": "1",
      "44": "1",
      "108": "1",
      "138": "1",
      "168": "1",
      "198": "1",
      "162": "1",
      "132": "1",
      "102": "1",
      "72": "1",
      "42": "1",
      "34": "1",
      "204": "1"
    },
    "2": {
      "179": "1",
      "149": "1",
      "119": "1",
      "89": "1",
      "59": "1",
      "213": "1",
      "183": "1",
      "153": "1",
      "123": "1",
      "93": "1",
      "17": "1",
      "19": "1",
      "51": "1",
      "49": "1",
      "187": "1",
      "189": "1",
      "221": "1",
      "219": "1"
    },
    "3": {
      "196": "1",
      "166": "1",
      "136": "1",
      "106": "1",
      "76": "1",
      "204": "1",
      "170": "1",
      "68": "1",
      "34": "1",
      "66": "1",
      "36": "1"
    },
    "4": {
      "211": "1",
      "181": "1",
      "151": "1",
      "121": "1",
      "91": "1",
      "61": "1",
      "187": "1",
      "85": "1",
      "51": "1",
      "53": "1",
      "83": "1",
      "153": "1",
      "119": "1",
      "123": "1",
      "89": "1",
      "93": "1",
      "59": "1",
      "183": "1",
      "149": "1",
      "213": "1",
      "179": "1",
      "185": "1",
      "155": "1"
    },
    "5": {
      "102": "1",
      "68": "1",
      "100": "1",
      "70": "1",
      "202": "1",
      "172": "1",
      "204": "1",
      "170": "1",
      "136": "1",
      "168": "1",
      "138": "1",
      "196": "1",
      "76": "1",
      "106": "1",
      "166": "1",
      "134": "1",
      "104": "1",
      "198": "1",
      "164": "1",
      "108": "1",
      "74": "1"
    },
    "6": {
      "85": "1",
      "87": "1",
      "119": "1",
      "117": "1",
      "187": "1",
      "153": "1",
      "181": "1",
      "151": "1",
      "121": "1",
      "149": "1",
      "89": "1",
      "91": "1"
    },
    "7": {
      "102": "1",
      "104": "1",
      "106": "1",
      "134": "1",
      "166": "1",
      "168": "1",
      "170": "1",
      "138": "1",
      "136": "1",
      "198": "1",
      "196": "1",
      "164": "1",
      "132": "1",
      "100": "1",
      "68": "1",
      "70": "1",
      "72": "1",
      "74": "1",
      "76": "1",
      "108": "1",
      "202": "1",
      "172": "1",
      "204": "1"
    },
    "8": {
      "83": "1",
      "53": "1",
      "115": "1",
      "147": "1",
      "179": "1",
      "181": "1",
      "183": "1",
      "185": "1",
      "187": "1",
      "85": "1",
      "117": "1",
      "149": "1",
      "151": "1",
      "153": "1",
      "155": "1",
      "123": "1",
      "91": "1",
      "59": "1",
      "57": "1",
      "55": "1",
      "87": "1",
      "89": "1",
      "121": "1",
      "119": "1",
      "51": "1"
    },
    "9": {
      "102": "1",
      "72": "1",
      "132": "1",
      "166": "1",
      "136": "1",
      "106": "1",
      "170": "1",
      "68": "1",
      "74": "1",
      "164": "1",
      "100": "1",
      "70": "1",
      "134": "1",
      "104": "1",
      "168": "1",
      "138": "1",
      "36": "1",
      "38": "1",
      "40": "1",
      "42": "1",
      "196": "1",
      "198": "1",
      "200": "1",
      "202": "1",
      "194": "1",
      "204": "1",
      "34": "1",
      "44": "1",
      "66": "1",
      "98": "1",
      "130": "1",
      "162": "1",
      "76": "1",
      "108": "1",
      "140": "1",
      "172": "1"
    },
    "10": {
      "87": "1",
      "117": "1",
      "119": "1",
      "121": "1",
      "151": "1",
      "187": "1",
      "181": "1",
      "91": "1",
      "147": "1",
      "115": "1",
      "57": "1",
      "55": "1",
      "83": "1",
      "53": "1",
      "51": "1",
      "183": "1",
      "123": "1",
      "185": "1",
      "155": "1",
      "179": "1",
      "59": "1"
    }
  },
  "TileItemArray": [],
  "TotalItemNum": 13,
  "MoveVect": [
    0.0,
    0.0
  ],
  "TileTotalNum": 0,
  "TileLevelHardType": "Normal",
  "TotalCount": 207
}