{
  "AllLayerTileDict": {
    "1": {
      "34": "1",
      "194": "1",
      "44": "1",
      "204": "1",
      "68": "1",
      "164": "1",
      "74": "1",
      "170": "1"
    },
    "2": {
      "49": "1",
      "177": "1",
      "51": "1",
      "179": "1",
      "53": "1",
      "181": "1",
      "57": "1",
      "185": "1",
      "59": "1",
      "187": "1",
      "61": "1",
      "189": "1",
      "83": "1",
      "147": "1",
      "91": "1",
      "155": "1",
      "85": "1",
      "149": "1",
      "89": "1",
      "153": "1"
    },
    "3": {
      "66": "1",
      "162": "1",
      "68": "1",
      "164": "1",
      "70": "1",
      "166": "1",
      "72": "1",
      "168": "1",
      "74": "1",
      "170": "1",
      "76": "1",
      "172": "1",
      "100": "1",
      "132": "1",
      "106": "1",
      "138": "1"
    },
    "4": {
      "83": "1",
      "147": "1",
      "85": "1",
      "149": "1",
      "87": "1",
      "151": "1",
      "89": "1",
      "153": "1",
      "91": "1",
      "155": "1",
      "117": "1",
      "121": "1"
    },
    "5": {
      "140": "1",
      "130": "1",
      "108": "1",
      "98": "1",
      "100": "1",
      "106": "1",
      "132": "1",
      "138": "1",
      "102": "1",
      "104": "1",
      "136": "1",
      "134": "1"
    },
    "6": {
      "83": "1",
      "85": "1",
      "87": "1",
      "89": "1",
      "91": "1",
      "155": "1",
      "153": "1",
      "151": "1",
      "149": "1",
      "147": "1"
    },
    "7": {
      "98": "1",
      "108": "1",
      "130": "1",
      "140": "1",
      "102": "1",
      "104": "1",
      "136": "1",
      "134": "1",
      "162": "1",
      "66": "1",
      "70": "1",
      "72": "1",
      "166": "1",
      "168": "1",
      "76": "1",
      "172": "1"
    },
    "8": {
      "147": "1",
      "155": "1",
      "115": "1",
      "123": "1",
      "83": "1",
      "91": "1",
      "51": "1",
      "59": "1",
      "179": "1",
      "187": "1",
      "53": "1",
      "85": "1",
      "89": "1",
      "149": "1",
      "153": "1",
      "181": "1",
      "183": "1",
      "55": "1",
      "185": "1",
      "57": "1",
      "177": "1",
      "49": "1",
      "61": "1",
      "189": "1",
      "113": "1",
      "125": "1"
    }
  },
  "TileItemArray": [],
  "TotalItemNum": 11,
  "MoveVect": [
    0.0,
    0.0
  ],
  "TileTotalNum": 0,
  "TileLevelHardType": "Normal",
  "TotalCount": 120
}