{
  "AllLayerTileDict": {
    "1": {
      "59": "1",
      "187": "1",
      "51": "1",
      "179": "1",
      "41": "1",
      "201": "1",
      "37": "1",
      "197": "1",
      "23": "1",
      "215": "1",
      "65": "1",
      "161": "1",
      "77": "1",
      "173": "1",
      "97": "1",
      "109": "1",
      "129": "1",
      "141": "1",
      "119": "1"
    },
    "2": {
      "102": "1",
      "104": "1",
      "136": "1",
      "134": "1",
      "50": "1",
      "178": "1",
      "60": "1",
      "188": "1",
      "36": "1",
      "196": "1",
      "42": "1",
      "202": "1",
      "22": "1",
      "214": "1",
      "24": "1",
      "216": "1",
      "82": "1",
      "92": "1",
      "114": "1",
      "124": "1",
      "146": "1",
      "156": "1"
    },
    "3": {
      "85": "1",
      "87": "1",
      "89": "1",
      "121": "1",
      "153": "1",
      "151": "1",
      "149": "1",
      "117": "1",
      "39": "1",
      "199": "1",
      "35": "1",
      "195": "1",
      "37": "1",
      "197": "1",
      "41": "1",
      "201": "1",
      "43": "1",
      "203": "1",
      "75": "1",
      "67": "1",
      "107": "1",
      "99": "1",
      "139": "1",
      "131": "1",
      "171": "1",
      "163": "1"
    },
    "4": {
      "136": "1",
      "134": "1",
      "52": "1",
      "54": "1",
      "56": "1",
      "58": "1",
      "90": "1",
      "122": "1",
      "154": "1",
      "186": "1",
      "184": "1",
      "182": "1",
      "180": "1",
      "148": "1",
      "116": "1",
      "84": "1",
      "104": "1",
      "102": "1"
    },
    "5": {
      "85": "1",
      "87": "1",
      "89": "1",
      "121": "1",
      "153": "1",
      "151": "1",
      "149": "1",
      "117": "1",
      "53": "1",
      "55": "1",
      "57": "1",
      "181": "1",
      "183": "1",
      "185": "1",
      "119": "1",
      "67": "1",
      "75": "1",
      "163": "1",
      "171": "1"
    },
    "6": {
      "68": "1",
      "164": "1",
      "70": "1",
      "166": "1",
      "72": "1",
      "168": "1",
      "74": "1",
      "170": "1",
      "100": "1",
      "132": "1",
      "102": "1",
      "134": "1",
      "104": "1",
      "136": "1",
      "106": "1",
      "138": "1",
      "196": "1",
      "198": "1",
      "200": "1",
      "202": "1",
      "36": "1",
      "38": "1",
      "40": "1",
      "42": "1"
    },
    "7": {
      "51": "1",
      "179": "1",
      "53": "1",
      "181": "1",
      "55": "1",
      "183": "1",
      "57": "1",
      "185": "1",
      "59": "1",
      "187": "1",
      "115": "1",
      "117": "1",
      "119": "1",
      "121": "1",
      "123": "1",
      "85": "1",
      "87": "1",
      "89": "1",
      "149": "1",
      "151": "1",
      "153": "1",
      "83": "1",
      "147": "1",
      "91": "1",
      "155": "1"
    },
    "8": {
      "44": "1",
      "34": "1",
      "204": "1",
      "194": "1",
      "76": "1",
      "66": "1",
      "172": "1",
      "162": "1",
      "108": "1",
      "98": "1",
      "140": "1",
      "130": "1",
      "68": "1",
      "164": "1",
      "70": "1",
      "166": "1",
      "72": "1",
      "168": "1",
      "74": "1",
      "170": "1",
      "100": "1",
      "132": "1",
      "102": "1",
      "134": "1",
      "104": "1",
      "136": "1",
      "106": "1",
      "138": "1"
    },
    "9": {
      "51": "1",
      "59": "1",
      "115": "1",
      "179": "1",
      "187": "1",
      "87": "1",
      "151": "1",
      "123": "1"
    }
  },
  "TileItemArray": [],
  "TotalItemNum": 15,
  "MoveVect": [
    0.0,
    0.0
  ],
  "TileTotalNum": 0,
  "TileLevelHardType": "Normal",
  "TotalCount": 189
}