{
  "AllLayerTileDict": {
    "1": {
      "17": "1",
      "29": "1",
      "49": "1",
      "61": "1",
      "81": "1",
      "93": "1",
      "83": "1",
      "91": "1",
      "85": "1",
      "89": "1",
      "53": "1",
      "57": "1",
      "21": "1",
      "25": "1",
      "19": "1",
      "27": "1",
      "116": "1",
      "122": "1",
      "134": "1",
      "136": "1",
      "167": "1"
    },
    "2": {
      "66": "1",
      "34": "1",
      "68": "1",
      "36": "1",
      "42": "1",
      "74": "1",
      "76": "1",
      "44": "1",
      "117": "1",
      "149": "1",
      "151": "1",
      "153": "1",
      "121": "1",
      "119": "1"
    },
    "3": {
      "51": "1",
      "83": "1",
      "101": "1",
      "133": "1",
      "165": "1",
      "167": "1",
      "169": "1",
      "137": "1",
      "105": "1",
      "91": "1",
      "59": "1"
    },
    "4": {
      "66": "1",
      "98": "1",
      "76": "1",
      "108": "1",
      "116": "1",
      "118": "1",
      "120": "1",
      "122": "1",
      "180": "1",
      "182": "1",
      "184": "1",
      "186": "1"
    },
    "5": {
      "81": "1",
      "93": "1",
      "113": "1",
      "125": "1",
      "131": "1",
      "133": "1",
      "135": "1",
      "137": "1",
      "139": "1",
      "197": "1",
      "195": "1",
      "199": "1",
      "201": "1",
      "203": "1"
    },
    "6": {
      "97": "1",
      "129": "1",
      "147": "1",
      "149": "1",
      "151": "1",
      "153": "1",
      "155": "1",
      "141": "1",
      "109": "1",
      "220": "1",
      "218": "1",
      "216": "1",
      "214": "1",
      "212": "1",
      "210": "1"
    },
    "7": {
      "197": "1",
      "195": "1",
      "193": "1",
      "199": "1",
      "201": "1",
      "203": "1",
      "205": "1",
      "138": "1",
      "135": "1",
      "132": "1",
      "163": "1",
      "165": "1",
      "167": "1",
      "169": "1",
      "171": "1",
      "113": "1",
      "125": "1",
      "145": "1",
      "157": "1",
      "81": "1",
      "93": "1"
    }
  },
  "TileItemArray": [],
  "TotalItemNum": 12,
  "MoveVect": [
    0.0,
    0.0
  ],
  "TileTotalNum": 0,
  "TileLevelHardType": "Hard",
  "TotalCount": 108
}