{
  "AllLayerTileDict": {
    "1": {
      "119": "1",
      "34": "1",
      "194": "1",
      "44": "1",
      "204": "1"
    },
    "2": {
      "17": "1",
      "49": "1",
      "51": "1",
      "19": "1",
      "27": "1",
      "59": "1",
      "61": "1",
      "29": "1",
      "102": "1",
      "134": "1",
      "136": "1",
      "104": "1",
      "177": "1",
      "209": "1",
      "211": "1",
      "179": "1",
      "187": "1",
      "219": "1",
      "221": "1",
      "189": "1"
    },
    "3": {
      "34": "1",
      "66": "1",
      "44": "1",
      "76": "1",
      "194": "1",
      "162": "1",
      "204": "1",
      "172": "1",
      "85": "1",
      "87": "1",
      "89": "1",
      "121": "1",
      "153": "1",
      "151": "1",
      "149": "1",
      "117": "1"
    },
    "4": {
      "50": "1",
      "178": "1",
      "82": "1",
      "146": "1",
      "60": "1",
      "188": "1",
      "92": "1",
      "156": "1",
      "100": "1",
      "102": "1",
      "104": "1",
      "106": "1",
      "132": "1",
      "134": "1",
      "136": "1",
      "138": "1"
    },
    "5": {
      "67": "1",
      "163": "1",
      "65": "1",
      "161": "1",
      "75": "1",
      "171": "1",
      "77": "1",
      "173": "1",
      "107": "1",
      "105": "1",
      "103": "1",
      "101": "1",
      "99": "1",
      "131": "1",
      "133": "1",
      "135": "1",
      "137": "1",
      "139": "1"
    },
    "6": {
      "81": "1",
      "145": "1",
      "83": "1",
      "147": "1",
      "85": "1",
      "149": "1",
      "87": "1",
      "151": "1",
      "89": "1",
      "153": "1",
      "91": "1",
      "155": "1",
      "93": "1",
      "157": "1",
      "114": "1",
      "116": "1",
      "118": "1",
      "120": "1",
      "122": "1",
      "124": "1"
    },
    "7": {
      "97": "1",
      "109": "1",
      "129": "1",
      "141": "1",
      "161": "1",
      "163": "1",
      "67": "1",
      "165": "1",
      "69": "1",
      "167": "1",
      "71": "1",
      "169": "1",
      "73": "1",
      "171": "1",
      "75": "1",
      "173": "1",
      "65": "1",
      "77": "1",
      "138": "1",
      "132": "1",
      "106": "1",
      "100": "1",
      "103": "1",
      "135": "1"
    },
    "8": {
      "49": "1",
      "177": "1",
      "51": "1",
      "179": "1",
      "53": "1",
      "181": "1",
      "55": "1",
      "183": "1",
      "57": "1",
      "185": "1",
      "59": "1",
      "187": "1",
      "61": "1",
      "189": "1",
      "92": "1",
      "82": "1",
      "124": "1",
      "114": "1",
      "156": "1",
      "146": "1",
      "85": "1",
      "117": "1",
      "149": "1",
      "89": "1",
      "121": "1",
      "153": "1",
      "87": "1",
      "151": "1"
    }
  },
  "TileItemArray": [],
  "TotalItemNum": 13,
  "MoveVect": [
    0.0,
    0.0
  ],
  "TileTotalNum": 0,
  "TileLevelHardType": "Normal",
  "TotalCount": 147
}