{
  "AllLayerTileDict": {
    "1": {
      "18": "1",
      "28": "1",
      "210": "1",
      "220": "1",
      "50": "1",
      "60": "1",
      "178": "1",
      "188": "1",
      "98": "1",
      "108": "1",
      "130": "1",
      "140": "1",
      "36": "1",
      "196": "1",
      "38": "1",
      "198": "1",
      "40": "1",
      "200": "1",
      "42": "1",
      "202": "1",
      "116": "1",
      "118": "1",
      "120": "1",
      "122": "1"
    },
    "2": {
      "33": "1",
      "193": "1",
      "35": "1",
      "195": "1",
      "37": "1",
      "197": "1",
      "39": "1",
      "199": "1",
      "41": "1",
      "201": "1",
      "43": "1",
      "203": "1",
      "45": "1",
      "205": "1",
      "113": "1",
      "115": "1",
      "117": "1",
      "119": "1",
      "121": "1",
      "123": "1",
      "125": "1"
    },
    "3": {
      "50": "1",
      "178": "1",
      "52": "1",
      "180": "1",
      "54": "1",
      "182": "1",
      "56": "1",
      "184": "1",
      "58": "1",
      "186": "1",
      "60": "1",
      "188": "1",
      "98": "1",
      "100": "1",
      "102": "1",
      "104": "1",
      "106": "1",
      "108": "1",
      "140": "1",
      "138": "1",
      "136": "1",
      "134": "1",
      "132": "1",
      "130": "1"
    },
    "4": {
      "67": "1",
      "69": "1",
      "71": "1",
      "73": "1",
      "75": "1",
      "163": "1",
      "165": "1",
      "167": "1",
      "169": "1",
      "171": "1",
      "115": "1",
      "117": "1",
      "119": "1",
      "121": "1",
      "123": "1"
    },
    "5": {
      "84": "1",
      "116": "1",
      "148": "1",
      "150": "1",
      "152": "1",
      "154": "1",
      "122": "1",
      "90": "1",
      "86": "1",
      "88": "1",
      "118": "1",
      "120": "1"
    },
    "6": {
      "67": "1",
      "163": "1",
      "69": "1",
      "165": "1",
      "71": "1",
      "167": "1",
      "73": "1",
      "169": "1",
      "75": "1",
      "107": "1",
      "99": "1",
      "139": "1",
      "131": "1",
      "171": "1",
      "101": "1",
      "133": "1",
      "135": "1",
      "137": "1",
      "105": "1",
      "103": "1"
    },
    "7": {
      "82": "1",
      "146": "1",
      "92": "1",
      "156": "1",
      "50": "1",
      "178": "1",
      "60": "1",
      "188": "1",
      "52": "1",
      "180": "1",
      "58": "1",
      "186": "1",
      "86": "1",
      "150": "1",
      "88": "1",
      "152": "1",
      "120": "1",
      "118": "1"
    },
    "8": {
      "67": "1",
      "163": "1",
      "69": "1",
      "165": "1",
      "71": "1",
      "167": "1",
      "73": "1",
      "169": "1",
      "75": "1",
      "171": "1",
      "107": "1",
      "99": "1",
      "139": "1",
      "131": "1",
      "103": "1",
      "135": "1"
    }
  },
  "TileItemArray": [],
  "TotalItemNum": 12,
  "MoveVect": [
    0.0,
    0.0
  ],
  "TileTotalNum": 0,
  "TileLevelHardType": "Normal",
  "TotalCount": 150
}