{
  "AllLayerTileDict": {
    "1": {
      "34": "1",
      "44": "1",
      "194": "1",
      "204": "1"
    },
    "2": {
      "51": "1",
      "179": "1",
      "59": "1",
      "187": "1"
    },
    "3": {
      "68": "1",
      "74": "1",
      "164": "1",
      "170": "1"
    },
    "4": {
      "85": "1",
      "89": "1",
      "149": "1",
      "153": "1"
    },
    "5": {
      "102": "1",
      "104": "1",
      "134": "1",
      "136": "1"
    },
    "6": {
      "119": "1",
      "117": "1",
      "87": "1",
      "121": "1",
      "151": "1"
    },
    "7": {
      "71": "1",
      "116": "1",
      "102": "1",
      "134": "1",
      "104": "1",
      "136": "1",
      "167": "1",
      "122": "1"
    },
    "8": {
      "119": "1",
      "87": "1",
      "117": "1",
      "121": "1",
      "151": "1",
      "55": "1",
      "115": "1",
      "123": "1",
      "183": "1"
    },
    "9": {
      "102": "1",
      "104": "1",
      "136": "1",
      "134": "1",
      "71": "1",
      "167": "1",
      "39": "1",
      "199": "1",
      "116": "1",
      "122": "1",
      "114": "1",
      "124": "1"
    },
    "10": {
      "87": "1",
      "151": "1",
      "117": "1",
      "121": "1",
      "115": "1",
      "123": "1",
      "113": "1",
      "125": "1",
      "55": "1",
      "183": "1",
      "23": "1",
      "215": "1"
    },
    "11": {
      "141": "1",
      "99": "1",
      "139": "1",
      "97": "1",
      "105": "1",
      "133": "1",
      "107": "1",
      "101": "1",
      "109": "1",
      "129": "1",
      "137": "1",
      "131": "1",
      "39": "1",
      "135": "1",
      "167": "1",
      "199": "1",
      "103": "1",
      "71": "1"
    },
    "12": {
      "145": "1",
      "183": "1",
      "93": "1",
      "157": "1",
      "91": "1",
      "147": "1",
      "81": "1",
      "155": "1",
      "89": "1",
      "153": "1",
      "87": "1",
      "149": "1",
      "83": "1",
      "151": "1",
      "85": "1",
      "55": "1"
    },
    "13": {
      "69": "1",
      "165": "1",
      "73": "1",
      "169": "1",
      "71": "1",
      "167": "1",
      "77": "1",
      "173": "1",
      "65": "1",
      "161": "1",
      "99": "1",
      "107": "1",
      "75": "1",
      "171": "1",
      "67": "1",
      "163": "1",
      "103": "1",
      "135": "1",
      "131": "1",
      "139": "1"
    },
    "14": {
      "87": "1",
      "151": "1",
      "83": "1",
      "91": "1",
      "147": "1",
      "155": "1",
      "51": "1",
      "179": "1",
      "53": "1",
      "181": "1",
      "55": "1",
      "183": "1",
      "57": "1",
      "185": "1",
      "49": "1",
      "177": "1",
      "59": "1",
      "187": "1",
      "61": "1",
      "189": "1"
    },
    "15": {
      "33": "1",
      "193": "1",
      "35": "1",
      "195": "1",
      "37": "1",
      "197": "1",
      "39": "1",
      "199": "1",
      "41": "1",
      "201": "1",
      "43": "1",
      "203": "1",
      "45": "1",
      "205": "1",
      "71": "1",
      "167": "1",
      "67": "1",
      "75": "1",
      "163": "1",
      "171": "1"
    },
    "16": {
      "17": "1",
      "209": "1",
      "19": "1",
      "211": "1",
      "21": "1",
      "213": "1",
      "23": "1",
      "215": "1",
      "25": "1",
      "217": "1",
      "27": "1",
      "219": "1",
      "29": "1",
      "221": "1",
      "51": "1",
      "59": "1",
      "179": "1",
      "187": "1",
      "55": "1",
      "183": "1"
    }
  },
  "TileItemArray": [],
  "TotalItemNum": 6,
  "MoveVect": [
    0.0,
    0.0
  ],
  "TileTotalNum": 0,
  "TileLevelHardType": "Normal",
  "TotalCount": 180
}