{
  "AllLayerTileDict": {
    "1": {
      "17": "-2",
      "29": "-2",
      "37": "-2",
      "23": "-2",
      "41": "-2",
      "215": "1",
      "209": "0",
      "221": "-1"
    },
    "2": {
      "17": "-2",
      "29": "-2",
      "37": "-2",
      "23": "-2",
      "41": "-2",
      "198": "1",
      "200": "1",
      "209": "0",
      "221": "-1"
    },
    "3": {
      "17": "-2",
      "29": "-2",
      "37": "-2",
      "23": "-2",
      "41": "-2",
      "181": "1",
      "183": "1",
      "185": "1",
      "209": "0",
      "221": "-1"
    },
    "4": {
      "17": "-2",
      "29": "-2",
      "37": "-2",
      "23": "-2",
      "41": "-2",
      "164": "1",
      "166": "1",
      "168": "1",
      "170": "1",
      "209": "0",
      "221": "-1"
    },
    "5": {
      "17": "-2",
      "29": "-2",
      "37": "-2",
      "23": "-2",
      "41": "-2",
      "147": "1",
      "149": "1",
      "151": "1",
      "153": "1",
      "155": "1",
      "209": "0",
      "221": "-1"
    },
    "6": {
      "17": "-2",
      "29": "-2",
      "37": "-2",
      "23": "-2",
      "41": "-2",
      "130": "1",
      "132": "1",
      "134": "1",
      "136": "1",
      "138": "1",
      "140": "1",
      "209": "0",
      "221": "-1"
    },
    "7": {
      "17": "-2",
      "29": "-2",
      "37": "-2",
      "23": "-2",
      "41": "-2",
      "113": "1",
      "115": "1",
      "117": "1",
      "119": "1",
      "121": "1",
      "123": "1",
      "125": "1",
      "209": "0",
      "221": "-1"
    },
    "8": {
      "17": "-2",
      "29": "-2",
      "37": "-2",
      "23": "-2",
      "41": "-2",
      "97": "1",
      "99": "1",
      "101": "1",
      "105": "1",
      "107": "1",
      "109": "1",
      "209": "0",
      "221": "-1",
      "103": "1"
    },
    "9": {
      "17": "-2",
      "29": "-2",
      "37": "-2",
      "23": "-2",
      "41": "-2",
      "209": "0",
      "221": "-1"
    },
    "10": {
      "17": "-2",
      "29": "-2",
      "41": "-2",
      "23": "-2",
      "37": "-2",
      "209": "0",
      "221": "-1"
    }
  },
  "TileItemArray": [],
  "TotalItemNum": 10,
  "MoveVect": [
    0.0,
    0.0
  ],
  "TileTotalNum": 0,
  "TileLevelHardType": "Normal",
  "TotalCount": 105
}