{
  "AllLayerTileDict": {
    "1": {
      "17": "1",
      "49": "1",
      "81": "1",
      "113": "1",
      "145": "1",
      "177": "1",
      "209": "1",
      "179": "1",
      "51": "1",
      "85": "1",
      "119": "1",
      "149": "1",
      "30": "1",
      "222": "1",
      "28": "1",
      "220": "1",
      "26": "1",
      "218": "1",
      "122": "1",
      "124": "1",
      "126": "1"
    },
    "2": {
      "34": "1",
      "66": "1",
      "98": "1",
      "130": "1",
      "194": "1",
      "162": "1",
      "164": "1",
      "68": "1",
      "102": "1",
      "134": "1",
      "42": "1",
      "202": "1",
      "44": "1",
      "204": "1",
      "46": "1",
      "206": "1",
      "123": "1",
      "125": "1"
    },
    "3": {
      "51": "1",
      "83": "1",
      "115": "1",
      "147": "1",
      "179": "1",
      "85": "1",
      "119": "1",
      "149": "1",
      "62": "1",
      "190": "1",
      "60": "1",
      "188": "1",
      "58": "1",
      "186": "1",
      "122": "1",
      "124": "1",
      "126": "1",
      "117": "1"
    },
    "4": {
      "68": "1",
      "100": "1",
      "132": "1",
      "164": "1",
      "102": "1",
      "134": "1",
      "78": "1",
      "174": "1",
      "76": "1",
      "172": "1",
      "74": "1",
      "170": "1",
      "123": "1",
      "125": "1"
    },
    "5": {
      "85": "1",
      "117": "1",
      "149": "1",
      "119": "1",
      "94": "1",
      "158": "1",
      "92": "1",
      "156": "1",
      "90": "1",
      "154": "1",
      "122": "1",
      "124": "1",
      "126": "1"
    },
    "6": {
      "110": "1",
      "142": "1",
      "108": "1",
      "140": "1",
      "106": "1",
      "138": "1"
    },
    "7": {
      "126": "1",
      "124": "1",
      "122": "1"
    }
  },
  "TileItemArray": [],
  "TotalItemNum": 11,
  "MoveVect": [
    -0.5,
    0.0
  ],
  "TileTotalNum": 0,
  "TileLevelHardType": "Normal",
  "TotalCount": 93
}