{
  "AllLayerTileDict": {
    "1": {
      "17": "1",
      "177": "1",
      "21": "1",
      "209": "1",
      "25": "1",
      "157": "1",
      "29": "1",
      "145": "1",
      "189": "1",
      "221": "1"
    },
    "2": {
      "33": "1",
      "37": "1",
      "41": "1",
      "45": "1",
      "146": "1",
      "210": "1",
      "178": "1",
      "156": "1",
      "188": "1",
      "220": "1"
    },
    "3": {
      "49": "1",
      "53": "1",
      "57": "1",
      "61": "1",
      "147": "1",
      "179": "1",
      "211": "1",
      "155": "1",
      "187": "1",
      "219": "1"
    },
    "4": {
      "66": "-2",
      "70": "-2",
      "72": "-2",
      "76": "-2",
      "148": "1",
      "180": "1",
      "212": "1",
      "154": "1",
      "186": "1",
      "218": "1"
    },
    "5": {
      "66": "-2",
      "70": "-2",
      "72": "-2",
      "76": "-2",
      "149": "1",
      "181": "1",
      "213": "1",
      "153": "1",
      "185": "1",
      "217": "1"
    },
    "6": {
      "66": "-2",
      "70": "-2",
      "72": "-2",
      "76": "-2",
      "150": "1",
      "182": "1",
      "214": "1",
      "152": "1",
      "184": "1",
      "216": "1"
    },
    "7": {
      "66": "-2",
      "70": "-2",
      "72": "-2",
      "76": "-2",
      "163": "1",
      "165": "1",
      "167": "1",
      "161": "1",
      "169": "1",
      "171": "1",
      "199": "1",
      "197": "1",
      "195": "1",
      "193": "1",
      "201": "1",
      "203": "1",
      "205": "1",
      "173": "1"
    },
    "8": {
      "66": "-2",
      "70": "-2",
      "72": "-2",
      "76": "-2",
      "209": "1",
      "211": "1",
      "213": "1",
      "215": "1",
      "217": "1",
      "219": "1",
      "221": "1",
      "145": "1",
      "147": "1",
      "149": "1",
      "151": "1",
      "153": "1",
      "155": "1",
      "157": "1"
    },
    "9": {
      "66": "-2",
      "70": "-2",
      "72": "-2",
      "76": "-2",
      "196": "1",
      "198": "1",
      "200": "1",
      "202": "1",
      "204": "1",
      "166": "1",
      "194": "1",
      "164": "1",
      "168": "1",
      "172": "1",
      "170": "1",
      "162": "1"
    },
    "10": {
      "66": "-2",
      "70": "-2",
      "72": "-2",
      "76": "-2"
    },
    "11": {
      "66": "-2",
      "70": "-2",
      "72": "-2",
      "76": "-2"
    },
    "12": {
      "66": "-2",
      "70": "-2",
      "72": "-2",
      "76": "-2"
    },
    "13": {
      "66": "-2",
      "70": "-2",
      "72": "-2",
      "76": "-2"
    },
    "14": {
      "66": "-2",
      "70": "-2",
      "72": "-2",
      "76": "-2"
    }
  },
  "TileItemArray": [],
  "TotalItemNum": 12,
  "MoveVect": [
    0.0,
    0.0
  ],
  "TileTotalNum": 0,
  "TileLevelHardType": "Normal",
  "TotalCount": 132
}