{
  "AllLayerTileDict": {
    "1": {
      "25": "1",
      "217": "1",
      "21": "1",
      "213": "1",
      "113": "1",
      "125": "1",
      "69": "1",
      "165": "1",
      "73": "1",
      "169": "1"
    },
    "2": {
      "86": "1",
      "152": "1",
      "150": "1",
      "26": "1",
      "218": "1",
      "212": "1",
      "98": "1",
      "108": "1",
      "130": "1",
      "140": "1",
      "88": "1",
      "20": "1",
      "40": "1",
      "198": "1",
      "38": "1",
      "200": "1"
    },
    "3": {
      "211": "1",
      "219": "1",
      "55": "1",
      "107": "1",
      "99": "1",
      "19": "1",
      "183": "1",
      "27": "1",
      "87": "1",
      "151": "1",
      "181": "1",
      "185": "1",
      "53": "1",
      "57": "1",
      "131": "1",
      "139": "1"
    },
    "4": {
      "68": "1",
      "164": "1",
      "74": "1",
      "170": "1",
      "70": "1",
      "166": "1",
      "72": "1",
      "168": "1",
      "100": "1",
      "132": "1",
      "106": "1",
      "138": "1",
      "102": "1",
      "104": "1",
      "134": "1",
      "136": "1",
      "220": "1",
      "210": "1",
      "18": "1",
      "28": "1"
    },
    "5": {
      "83": "1",
      "115": "1",
      "147": "1",
      "91": "1",
      "123": "1",
      "155": "1",
      "181": "1",
      "149": "1",
      "151": "1",
      "183": "1",
      "153": "1",
      "185": "1",
      "85": "1",
      "87": "1",
      "89": "1",
      "117": "1",
      "119": "1",
      "121": "1",
      "221": "1",
      "209": "1",
      "29": "1",
      "17": "1"
    },
    "6": {
      "76": "1",
      "162": "1",
      "164": "1",
      "166": "1",
      "168": "1",
      "170": "1",
      "172": "1",
      "131": "1",
      "99": "1",
      "74": "1",
      "72": "1",
      "70": "1",
      "68": "1",
      "66": "1",
      "107": "1",
      "139": "1",
      "102": "1",
      "104": "1",
      "134": "1",
      "136": "1"
    },
    "7": {
      "84": "1",
      "90": "1",
      "86": "1",
      "55": "1",
      "53": "1",
      "148": "1",
      "154": "1",
      "116": "1",
      "179": "1",
      "187": "1",
      "183": "1",
      "181": "1",
      "59": "1",
      "122": "1",
      "185": "1",
      "57": "1",
      "51": "1",
      "118": "1",
      "150": "1",
      "88": "1",
      "120": "1",
      "152": "1"
    }
  },
  "TileItemArray": [],
  "TotalItemNum": 15,
  "MoveVect": [
    0.0,
    0.0
  ],
  "TileTotalNum": 0,
  "TileLevelHardType": "Normal",
  "TotalCount": 126
}