{
  "AllLayerTileDict": {
    "1": {
      "170": "1",
      "74": "1",
      "183": "1",
      "36": "1",
      "209": "1",
      "177": "1",
      "145": "1",
      "68": "1",
      "17": "1",
      "49": "1",
      "81": "1",
      "55": "1",
      "164": "1",
      "196": "1",
      "93": "1",
      "157": "1"
    },
    "2": {
      "97": "1",
      "129": "1",
      "37": "1",
      "197": "1",
      "35": "1",
      "195": "1",
      "33": "1",
      "193": "1",
      "109": "1",
      "141": "1",
      "69": "1",
      "165": "1",
      "71": "1",
      "167": "1",
      "73": "1",
      "169": "1"
    },
    "3": {
      "49": "1",
      "177": "1",
      "51": "1",
      "179": "1",
      "53": "1",
      "181": "1",
      "55": "1",
      "183": "1",
      "57": "1",
      "185": "1",
      "114": "1",
      "124": "1"
    },
    "4": {
      "66": "1",
      "162": "1",
      "68": "1",
      "164": "1",
      "70": "1",
      "166": "1",
      "72": "1",
      "168": "1",
      "74": "1",
      "170": "1",
      "115": "1",
      "123": "1",
      "125": "1"
    },
    "5": {
      "83": "1",
      "147": "1",
      "85": "1",
      "149": "1",
      "87": "1",
      "151": "1",
      "89": "1",
      "153": "1",
      "91": "1",
      "155": "1",
      "114": "1",
      "116": "1",
      "122": "1",
      "124": "1"
    },
    "6": {
      "113": "1",
      "115": "1",
      "125": "1",
      "123": "1",
      "121": "1",
      "117": "1",
      "66": "1",
      "162": "1",
      "68": "1",
      "164": "1",
      "70": "1",
      "166": "1",
      "72": "1",
      "168": "1",
      "74": "1",
      "170": "1",
      "76": "1",
      "172": "1"
    },
    "7": {
      "49": "1",
      "177": "1",
      "51": "1",
      "179": "1",
      "53": "1",
      "181": "1",
      "55": "1",
      "183": "1",
      "57": "1",
      "185": "1",
      "59": "1",
      "187": "1",
      "61": "1",
      "189": "1",
      "120": "1",
      "118": "1",
      "124": "1",
      "122": "1",
      "116": "1",
      "114": "1",
      "151": "1",
      "87": "1"
    }
  },
  "TileItemArray": [],
  "TotalItemNum": 11,
  "MoveVect": [
    0.0,
    0.0
  ],
  "TileTotalNum": 0,
  "TileLevelHardType": "Normal",
  "TotalCount": 111
}