{
  "AllLayerTileDict": {
    "1": {
      "23": "-2",
      "41": "-2",
      "37": "-2",
      "51": "-2",
      "59": "-2",
      "65": "-2",
      "77": "-2",
      "215": "1"
    },
    "2": {
      "23": "-2",
      "41": "-2",
      "37": "-2",
      "51": "-2",
      "59": "-2",
      "65": "-2",
      "77": "-2",
      "198": "1",
      "200": "1"
    },
    "3": {
      "23": "-2",
      "41": "-2",
      "37": "-2",
      "51": "-2",
      "59": "-2",
      "65": "-2",
      "77": "-2",
      "181": "1",
      "183": "1",
      "185": "1",
      "213": "1",
      "217": "1"
    },
    "4": {
      "23": "-2",
      "41": "-2",
      "37": "-2",
      "51": "-2",
      "59": "-2",
      "65": "-2",
      "77": "-2",
      "164": "1",
      "166": "1",
      "168": "1",
      "170": "1",
      "196": "1",
      "202": "1"
    },
    "5": {
      "23": "-2",
      "41": "-2",
      "37": "-2",
      "51": "-2",
      "59": "-2",
      "65": "-2",
      "77": "-2",
      "147": "1",
      "149": "1",
      "151": "1",
      "153": "1",
      "155": "1",
      "179": "1",
      "211": "1",
      "187": "1",
      "219": "1"
    },
    "6": {
      "23": "-2",
      "37": "-2",
      "41": "-2",
      "51": "-2",
      "59": "-2",
      "65": "-2",
      "77": "-2",
      "130": "1",
      "132": "1",
      "134": "1",
      "136": "1",
      "138": "1",
      "140": "1",
      "162": "1",
      "194": "1",
      "172": "1",
      "204": "1",
      "164": "1",
      "196": "1",
      "170": "1",
      "202": "1"
    },
    "7": {
      "115": "1",
      "117": "1",
      "119": "1",
      "121": "1",
      "123": "1",
      "145": "1",
      "189": "1",
      "221": "1",
      "157": "1",
      "209": "1",
      "177": "1",
      "113": "1",
      "125": "1",
      "147": "1",
      "179": "1",
      "155": "1",
      "187": "1",
      "211": "1",
      "219": "1"
    },
    "8": {
      "130": "1",
      "140": "1",
      "162": "1",
      "172": "1",
      "204": "1",
      "194": "1",
      "136": "1",
      "134": "1",
      "132": "1",
      "138": "1",
      "166": "1",
      "103": "1",
      "101": "1",
      "105": "1",
      "164": "1",
      "196": "1",
      "170": "1",
      "202": "1",
      "168": "1"
    }
  },
  "TileItemArray": [],
  "TotalItemNum": 14,
  "MoveVect": [
    0.0,
    0.0
  ],
  "TileTotalNum": 0,
  "TileLevelHardType": "Normal",
  "TotalCount": 117
}