{
  "AllLayerTileDict": {
    "1": {
      "87": "1",
      "17": "-2",
      "36": "-2",
      "29": "-2",
      "42": "-2",
      "81": "-2",
      "93": "-2"
    },
    "2": {
      "102": "1",
      "104": "1",
      "17": "-2",
      "36": "-2",
      "29": "-2",
      "42": "-2",
      "81": "-2",
      "93": "-2"
    },
    "3": {
      "117": "1",
      "119": "1",
      "121": "1",
      "17": "-2",
      "36": "-2",
      "29": "-2",
      "42": "-2",
      "81": "-2",
      "93": "-2"
    },
    "4": {
      "132": "1",
      "134": "1",
      "136": "1",
      "138": "1",
      "17": "-2",
      "36": "-2",
      "29": "-2",
      "42": "-2",
      "81": "-2",
      "93": "-2"
    },
    "5": {
      "147": "1",
      "149": "1",
      "151": "1",
      "153": "1",
      "155": "1",
      "17": "-2",
      "36": "-2",
      "29": "-2",
      "42": "-2",
      "81": "-2",
      "93": "-2"
    },
    "6": {
      "162": "1",
      "164": "1",
      "166": "1",
      "168": "1",
      "170": "1",
      "172": "1",
      "17": "-2",
      "36": "-2",
      "29": "-2",
      "42": "-2",
      "81": "-2",
      "93": "-2"
    },
    "7": {
      "177": "1",
      "179": "1",
      "181": "1",
      "183": "1",
      "185": "1",
      "187": "1",
      "189": "1",
      "17": "-2",
      "36": "-2",
      "29": "-2",
      "42": "-2",
      "81": "-2",
      "93": "-2"
    },
    "8": {
      "193": "1",
      "195": "1",
      "197": "1",
      "199": "1",
      "201": "1",
      "203": "1",
      "205": "1",
      "17": "-2",
      "36": "-2",
      "29": "-2",
      "42": "-2",
      "81": "-2",
      "93": "-2"
    },
    "9": {
      "209": "1",
      "211": "1",
      "213": "1",
      "215": "1",
      "217": "1",
      "219": "1",
      "221": "1",
      "17": "-2",
      "36": "-2",
      "29": "-2",
      "42": "-2",
      "81": "-2",
      "93": "-2"
    }
  },
  "TileItemArray": [],
  "TotalItemNum": 8,
  "MoveVect": [
    0.0,
    0.0
  ],
  "TileTotalNum": 0,
  "TileLevelHardType": "Normal",
  "TotalCount": 96
}