{
  "AllLayerTileDict": {
    "1": {
      "211": "1",
      "19": "1",
      "215": "1",
      "23": "1",
      "219": "1",
      "27": "1"
    },
    "2": {
      "194": "1",
      "34": "1",
      "198": "1",
      "38": "1",
      "200": "1",
      "40": "1",
      "204": "1",
      "44": "1"
    },
    "3": {
      "177": "1",
      "49": "1",
      "189": "1",
      "61": "1",
      "181": "1",
      "53": "1",
      "183": "1",
      "55": "1",
      "185": "1",
      "57": "1"
    },
    "4": {
      "161": "1",
      "65": "1",
      "173": "1",
      "77": "1",
      "164": "1",
      "68": "1",
      "166": "1",
      "70": "1",
      "168": "1",
      "72": "1",
      "170": "1",
      "74": "1"
    },
    "5": {
      "145": "1",
      "81": "1",
      "157": "1",
      "93": "1",
      "147": "1",
      "83": "1",
      "149": "1",
      "85": "1",
      "151": "1",
      "87": "1",
      "153": "1",
      "89": "1",
      "155": "1",
      "91": "1"
    },
    "6": {
      "101": "1",
      "133": "1",
      "97": "1",
      "129": "1",
      "105": "1",
      "137": "1",
      "107": "1",
      "139": "1",
      "103": "1",
      "135": "1",
      "99": "1",
      "131": "1",
      "109": "1",
      "141": "1"
    },
    "7": {
      "115": "1",
      "119": "1",
      "123": "1",
      "91": "1",
      "89": "1",
      "87": "1",
      "85": "1",
      "83": "1",
      "81": "1",
      "93": "1",
      "145": "1",
      "147": "1",
      "149": "1",
      "151": "1",
      "153": "1",
      "155": "1",
      "157": "1",
      "125": "1",
      "121": "1",
      "117": "1",
      "113": "1"
    },
    "8": {
      "75": "1",
      "73": "1",
      "71": "1",
      "69": "1",
      "67": "1",
      "65": "1",
      "77": "1",
      "161": "1",
      "163": "1",
      "165": "1",
      "167": "1",
      "169": "1",
      "171": "1",
      "173": "1",
      "114": "1",
      "118": "1",
      "122": "1"
    },
    "9": {
      "57": "1",
      "55": "1",
      "53": "1",
      "51": "1",
      "49": "1",
      "59": "1",
      "61": "1",
      "177": "1",
      "179": "1",
      "181": "1",
      "183": "1",
      "185": "1",
      "187": "1",
      "189": "1",
      "113": "1",
      "117": "1",
      "121": "1"
    },
    "10": {
      "114": "1",
      "118": "1",
      "122": "1"
    },
    "11": {
      "119": "1",
      "115": "1",
      "123": "1"
    },
    "12": {
      "124": "1"
    }
  },
  "TileItemArray": [],
  "TotalItemNum": 13,
  "MoveVect": [
    0.0,
    0.0
  ],
  "TileTotalNum": 0,
  "TileLevelHardType": "Normal",
  "TotalCount": 126
}