{
  "AllLayerTileDict": {
    "1": {
      "17": "1",
      "29": "1",
      "23": "1"
    },
    "2": {
      "34": "1",
      "44": "1",
      "39": "1"
    },
    "3": {
      "51": "1",
      "59": "1",
      "55": "1"
    },
    "4": {
      "68": "1",
      "71": "1",
      "74": "1"
    },
    "5": {
      "85": "1",
      "87": "1",
      "89": "1",
      "117": "1",
      "119": "1",
      "121": "1",
      "153": "1",
      "151": "1",
      "149": "1"
    },
    "6": {
      "102": "1",
      "134": "1",
      "136": "1",
      "104": "1",
      "100": "1",
      "132": "1",
      "106": "1",
      "138": "1"
    },
    "7": {
      "117": "1",
      "153": "1",
      "121": "1",
      "119": "1",
      "151": "1",
      "149": "1",
      "115": "1",
      "147": "1",
      "123": "1",
      "155": "1"
    },
    "8": {
      "132": "1",
      "134": "1",
      "136": "1",
      "138": "1",
      "170": "1",
      "168": "1",
      "166": "1",
      "164": "1",
      "100": "1",
      "102": "1",
      "104": "1",
      "106": "1"
    },
    "9": {
      "147": "1",
      "149": "1",
      "151": "1",
      "153": "1",
      "155": "1",
      "187": "1",
      "185": "1",
      "183": "1",
      "181": "1",
      "179": "1",
      "115": "1",
      "117": "1",
      "119": "1",
      "121": "1",
      "123": "1"
    },
    "10": {
      "162": "1",
      "164": "1",
      "166": "1",
      "168": "1",
      "170": "1",
      "172": "1",
      "204": "1",
      "202": "1",
      "200": "1",
      "198": "1",
      "196": "1",
      "194": "1",
      "130": "1",
      "132": "1",
      "134": "1",
      "136": "1",
      "138": "1",
      "140": "1"
    },
    "11": {
      "177": "1",
      "179": "1",
      "181": "1",
      "183": "1",
      "185": "1",
      "187": "1",
      "189": "1",
      "221": "1",
      "219": "1",
      "217": "1",
      "215": "1",
      "213": "1",
      "211": "1",
      "209": "1",
      "145": "1",
      "147": "1",
      "149": "1",
      "151": "1",
      "153": "1",
      "155": "1",
      "157": "1"
    },
    "12": {
      "194": "1",
      "196": "1",
      "198": "1",
      "200": "1",
      "202": "1",
      "204": "1",
      "162": "1",
      "164": "1",
      "166": "1",
      "168": "1",
      "170": "1",
      "172": "1",
      "130": "1",
      "132": "1",
      "134": "1",
      "136": "1",
      "138": "1",
      "140": "1"
    }
  },
  "GoldTileCount": 0,
  "TileItemArray": [],
  "TotalItemNum": 11,
  "MoveVect": [
    0.0,
    0.0
  ],
  "TileTotalNum": 0,
  "TileLevelHardType": "Normal",
  "TotalCount": 123
}