{
  "AllLayerTileDict": {
    "1": {
      "215": "1",
      "18": "-2",
      "36": "-2",
      "22": "-2",
      "24": "-2",
      "42": "-2",
      "28": "-2",
      "193": "-2",
      "205": "-2"
    },
    "2": {
      "198": "1",
      "200": "1",
      "18": "-2",
      "36": "-2",
      "22": "-2",
      "24": "-2",
      "42": "-2",
      "28": "-2",
      "193": "-2",
      "205": "-2"
    },
    "3": {
      "181": "1",
      "183": "1",
      "185": "1",
      "18": "-2",
      "36": "-2",
      "22": "-2",
      "24": "-2",
      "42": "-2",
      "28": "-2",
      "193": "-2",
      "205": "-2"
    },
    "4": {
      "164": "1",
      "166": "1",
      "168": "1",
      "170": "1",
      "18": "-2",
      "36": "-2",
      "22": "-2",
      "24": "-2",
      "42": "-2",
      "28": "-2",
      "193": "-2",
      "205": "-2"
    },
    "5": {
      "147": "1",
      "149": "1",
      "151": "1",
      "153": "1",
      "155": "1",
      "18": "-2",
      "36": "-2",
      "22": "-2",
      "24": "-2",
      "42": "-2",
      "28": "-2",
      "193": "-2",
      "205": "-2"
    },
    "6": {
      "130": "1",
      "132": "1",
      "134": "1",
      "136": "1",
      "138": "1",
      "140": "1",
      "18": "-2",
      "36": "-2",
      "22": "-2",
      "24": "-2",
      "42": "-2",
      "28": "-2",
      "193": "-2",
      "205": "-2"
    },
    "7": {
      "113": "1",
      "115": "1",
      "117": "1",
      "119": "1",
      "121": "1",
      "123": "1",
      "125": "1",
      "18": "-2",
      "36": "-2",
      "22": "-2",
      "24": "-2",
      "42": "-2",
      "28": "-2",
      "193": "-2",
      "205": "-2"
    },
    "8": {
      "98": "1",
      "102": "1",
      "104": "1",
      "108": "1",
      "18": "-2",
      "36": "-2",
      "22": "-2",
      "24": "-2",
      "42": "-2",
      "28": "-2",
      "193": "-2",
      "205": "-2"
    }
  },
  "TileItemArray": [],
  "TotalItemNum": 10,
  "MoveVect": [
    0.0,
    0.0
  ],
  "TileTotalNum": 0,
  "TileLevelHardType": "Normal",
  "TotalCount": 96
}