{
  "AllLayerTileDict": {
    "1": {
      "209": "1",
      "221": "1",
      "211": "1",
      "219": "1",
      "213": "1",
      "217": "1",
      "177": "1",
      "189": "1",
      "145": "1",
      "157": "1",
      "147": "1",
      "155": "1",
      "149": "1",
      "153": "1",
      "181": "1",
      "185": "1",
      "179": "1",
      "187": "1",
      "26": "-2",
      "28": "-2",
      "84": "-2",
      "86": "-2",
      "20": "-2",
      "18": "-2",
      "90": "-2",
      "82": "-2",
      "92": "-2",
      "88": "-2",
      "24": "-2",
      "22": "-2"
    },
    "2": {
      "194": "1",
      "204": "1",
      "162": "1",
      "172": "1",
      "164": "1",
      "170": "1",
      "196": "1",
      "202": "1",
      "26": "-2",
      "28": "-2",
      "84": "-2",
      "86": "-2",
      "20": "-2",
      "18": "-2",
      "90": "-2",
      "82": "-2",
      "92": "-2",
      "88": "-2",
      "24": "-2",
      "22": "-2"
    },
    "3": {
      "179": "1",
      "187": "1",
      "26": "-2",
      "28": "-2",
      "84": "-2",
      "86": "-2",
      "20": "-2",
      "18": "-2",
      "90": "-2",
      "82": "-2",
      "92": "-2",
      "88": "-2",
      "24": "-2",
      "22": "-2"
    },
    "4": {
      "194": "1",
      "204": "1",
      "162": "1",
      "172": "1",
      "164": "1",
      "170": "1",
      "196": "1",
      "202": "1",
      "28": "-2",
      "84": "-2",
      "86": "-2",
      "24": "-2",
      "90": "-2",
      "82": "-2",
      "92": "-2",
      "22": "-2",
      "26": "-2",
      "88": "-2",
      "18": "-2",
      "20": "-2"
    },
    "5": {
      "209": "1",
      "221": "1",
      "177": "1",
      "189": "1",
      "145": "1",
      "157": "1",
      "147": "1",
      "155": "1",
      "149": "1",
      "153": "1",
      "181": "1",
      "185": "1",
      "213": "1",
      "217": "1",
      "211": "1",
      "219": "1",
      "187": "1"
    },
    "6": {
      "162": "1",
      "172": "1",
      "194": "1",
      "204": "1",
      "196": "1",
      "202": "1",
      "164": "1",
      "170": "1"
    },
    "7": {
      "179": "1",
      "187": "1"
    },
    "8": {
      "194": "1",
      "204": "1",
      "162": "1",
      "172": "1",
      "164": "1",
      "170": "1",
      "196": "1",
      "202": "1"
    },
    "9": {
      "209": "1",
      "221": "1",
      "177": "1",
      "189": "1",
      "145": "1",
      "157": "1",
      "147": "1",
      "155": "1",
      "149": "1",
      "153": "1",
      "213": "1",
      "217": "1",
      "181": "1",
      "185": "1",
      "211": "1",
      "219": "1",
      "179": "1",
      "187": "1"
    },
    "10": {
      "194": "1",
      "204": "1",
      "162": "1",
      "172": "1",
      "164": "1",
      "170": "1",
      "196": "1",
      "202": "1"
    },
    "11": {
      "179": "1",
      "187": "1"
    }
  },
  "TileItemArray": [],
  "TotalItemNum": 14,
  "MoveVect": [
    0.0,
    0.0
  ],
  "TileTotalNum": 0,
  "TileLevelHardType": "Normal",
  "TotalCount": 147
}