{
  "AllLayerTileDict": {
    "1": {
      "115": "1",
      "123": "1",
      "148": "1",
      "154": "1",
      "181": "1",
      "185": "1",
      "199": "1"
    },
    "2": {
      "99": "1",
      "107": "1",
      "132": "1",
      "138": "1",
      "165": "1",
      "169": "1",
      "183": "1"
    },
    "3": {
      "83": "1",
      "91": "1",
      "116": "1",
      "122": "1",
      "149": "1",
      "153": "1"
    },
    "4": {
      "68": "1",
      "74": "1",
      "100": "1",
      "106": "1",
      "137": "1",
      "133": "1",
      "151": "1",
      "36": "1",
      "42": "1"
    },
    "5": {
      "85": "1",
      "89": "1",
      "117": "1",
      "121": "1",
      "135": "1",
      "53": "1",
      "57": "1"
    },
    "6": {
      "101": "1",
      "105": "1",
      "129": "1",
      "141": "1",
      "161": "1",
      "173": "1",
      "194": "1",
      "204": "1",
      "212": "1",
      "218": "1",
      "134": "1",
      "136": "1",
      "103": "1"
    },
    "7": {
      "118": "1",
      "120": "1",
      "116": "1",
      "122": "1",
      "146": "1",
      "156": "1",
      "178": "1",
      "188": "1",
      "196": "1",
      "202": "1",
      "6": "1",
      "8": "1"
    },
    "8": {
      "133": "1",
      "135": "1",
      "137": "1",
      "131": "1",
      "139": "1",
      "163": "1",
      "171": "1",
      "197": "1",
      "201": "1",
      "7": "1"
    },
    "9": {
      "148": "1",
      "150": "1",
      "152": "1",
      "154": "1",
      "186": "1",
      "180": "1",
      "182": "1",
      "184": "1",
      "6": "1",
      "8": "1"
    },
    "10": {
      "165": "1",
      "169": "1",
      "133": "1",
      "137": "1",
      "70": "1",
      "72": "1",
      "38": "1",
      "40": "1",
      "151": "1",
      "183": "1",
      "7": "1",
      "5": "1",
      "9": "1"
    },
    "11": {
      "55": "1",
      "4": "1",
      "6": "1",
      "8": "1",
      "10": "1"
    }
  },
  "GoldTileCount": 0,
  "TileItemArray": [],
  "TotalItemNum": 12,
  "MoveVect": [
    0.0,
    0.5
  ],
  "TileTotalNum": 0,
  "TileLevelHardType": "Normal",
  "TotalCount": 99
}