{
  "AllLayerTileDict": {
    "1": {
      "136": "1",
      "134": "1",
      "166": "1",
      "168": "1",
      "28": "-2",
      "20": "-2",
      "26": "-2",
      "23": "-2",
      "18": "-2"
    },
    "2": {
      "119": "1",
      "117": "1",
      "149": "1",
      "181": "1",
      "183": "1",
      "185": "1",
      "153": "1",
      "121": "1",
      "28": "-2",
      "20": "-2",
      "26": "-2",
      "23": "-2",
      "18": "-2"
    },
    "3": {
      "196": "1",
      "198": "1",
      "164": "1",
      "132": "1",
      "100": "1",
      "28": "-2",
      "202": "1",
      "170": "1",
      "138": "1",
      "106": "1",
      "104": "1",
      "20": "-2",
      "26": "-2",
      "23": "-2",
      "18": "-2"
    },
    "4": {
      "179": "1",
      "147": "1",
      "115": "1",
      "215": "1",
      "211": "1",
      "213": "1",
      "83": "1",
      "91": "1",
      "89": "1",
      "87": "1",
      "123": "1",
      "155": "1",
      "187": "1",
      "219": "1",
      "28": "-2",
      "20": "-2",
      "26": "-2",
      "23": "-2",
      "18": "-2"
    },
    "5": {
      "28": "-2",
      "20": "-2",
      "26": "-2",
      "214": "1",
      "212": "1",
      "210": "1",
      "178": "1",
      "146": "1",
      "114": "1",
      "82": "1",
      "88": "1",
      "90": "1",
      "92": "1",
      "124": "1",
      "156": "1",
      "188": "1",
      "220": "1",
      "23": "-2",
      "18": "-2"
    },
    "6": {
      "28": "-2",
      "20": "-2",
      "26": "-2",
      "213": "1",
      "211": "1",
      "209": "1",
      "177": "1",
      "113": "1",
      "145": "1",
      "81": "1",
      "89": "1",
      "91": "1",
      "93": "1",
      "125": "1",
      "157": "1",
      "189": "1",
      "221": "1",
      "23": "-2",
      "18": "-2"
    },
    "7": {
      "28": "-2",
      "20": "-2",
      "26": "-2",
      "23": "-2",
      "18": "-2"
    },
    "8": {
      "28": "-2",
      "20": "-2",
      "26": "-2",
      "23": "-2",
      "18": "-2"
    },
    "9": {
      "20": "-2",
      "28": "-2",
      "26": "-2",
      "23": "-2",
      "18": "-2"
    },
    "10": {
      "26": "-2",
      "23": "-2",
      "20": "-2",
      "28": "-2",
      "18": "-2"
    }
  },
  "GoldTileCount": 0,
  "TileItemArray": [],
  "TotalItemNum": 11,
  "MoveVect": [
    0.0,
    0.0
  ],
  "TileTotalNum": 0,
  "TileLevelHardType": "Normal",
  "TotalCount": 114
}