{
  "AllLayerTileDict": {
    "1": {
      "110": "1",
      "226": "1",
      "142": "1",
      "174": "1",
      "206": "1",
      "238": "1",
      "224": "1",
      "236": "1",
      "234": "1",
      "232": "1",
      "192": "1",
      "160": "1",
      "128": "1",
      "106": "1",
      "108": "1",
      "100": "1",
      "230": "1",
      "228": "1",
      "98": "1",
      "96": "1"
    },
    "2": {
      "209": "1",
      "177": "1",
      "145": "1",
      "113": "1",
      "115": "1",
      "117": "1",
      "119": "1",
      "121": "1",
      "123": "1",
      "125": "1",
      "157": "1",
      "189": "1",
      "221": "1",
      "219": "1",
      "217": "1",
      "215": "1",
      "213": "1",
      "211": "1"
    },
    "3": {
      "194": "1",
      "162": "1",
      "130": "1",
      "132": "1",
      "134": "1",
      "136": "1",
      "138": "1",
      "140": "1",
      "172": "1",
      "204": "1",
      "202": "1",
      "200": "1",
      "198": "1",
      "196": "1"
    },
    "4": {
      "179": "1",
      "147": "1",
      "149": "1",
      "151": "1",
      "153": "1",
      "155": "1",
      "187": "1",
      "185": "1",
      "183": "1",
      "181": "1"
    },
    "5": {
      "194": "1",
      "162": "1",
      "130": "1",
      "132": "1",
      "68": "1",
      "36": "1",
      "4": "1",
      "6": "1",
      "8": "1",
      "10": "1",
      "42": "1",
      "74": "1",
      "134": "1",
      "136": "1",
      "138": "1",
      "172": "1",
      "140": "1",
      "204": "1",
      "202": "1",
      "200": "1",
      "198": "1",
      "196": "1"
    },
    "6": {
      "209": "1",
      "177": "1",
      "145": "1",
      "113": "1",
      "115": "1",
      "117": "1",
      "119": "1",
      "121": "1",
      "123": "1",
      "125": "1",
      "157": "1",
      "189": "1",
      "221": "1",
      "219": "1",
      "217": "1",
      "215": "1",
      "213": "1",
      "211": "1"
    },
    "7": {
      "194": "1",
      "162": "1",
      "130": "1",
      "132": "1",
      "134": "1",
      "136": "1",
      "138": "1",
      "140": "1",
      "172": "1",
      "204": "1",
      "202": "1",
      "200": "1",
      "198": "1",
      "196": "1",
      "164": "1",
      "170": "1"
    },
    "8": {
      "147": "1",
      "179": "1",
      "149": "1",
      "151": "1",
      "153": "1",
      "155": "1",
      "187": "1",
      "185": "1",
      "183": "1",
      "181": "1"
    },
    "9": {
      "164": "1",
      "166": "1",
      "168": "1",
      "170": "1"
    }
  },
  "GoldTileCount": 0,
  "TileItemArray": [],
  "TotalItemNum": 13,
  "MoveVect": [
    0.0,
    0.0
  ],
  "TileTotalNum": 0,
  "TileLevelHardType": "Normal",
  "TotalCount": 132
}