{
  "AllLayerTileDict": {
    "1": {
      "49": "1",
      "61": "1",
      "177": "1",
      "189": "1",
      "19": "1",
      "211": "1",
      "27": "1",
      "219": "1",
      "119": "1"
    },
    "2": {
      "34": "1",
      "44": "1",
      "194": "1",
      "204": "1",
      "102": "1",
      "134": "1",
      "136": "1",
      "104": "1"
    },
    "3": {
      "85": "1",
      "117": "1",
      "149": "1",
      "151": "1",
      "153": "1",
      "121": "1",
      "89": "1",
      "87": "1",
      "17": "1",
      "29": "1",
      "209": "1",
      "221": "1"
    },
    "4": {
      "68": "1",
      "74": "1",
      "164": "1",
      "170": "1",
      "102": "1",
      "134": "1",
      "136": "1",
      "104": "1",
      "34": "1",
      "44": "1",
      "204": "1",
      "194": "1",
      "71": "1",
      "116": "1",
      "122": "1",
      "167": "1"
    },
    "5": {
      "51": "1",
      "59": "1",
      "179": "1",
      "187": "1",
      "70": "1",
      "166": "1",
      "72": "1",
      "168": "1",
      "100": "1",
      "106": "1",
      "132": "1",
      "138": "1",
      "119": "1"
    },
    "6": {
      "66": "1",
      "162": "1",
      "76": "1",
      "172": "1",
      "36": "1",
      "196": "1",
      "42": "1",
      "202": "1",
      "85": "1",
      "153": "1",
      "89": "1",
      "149": "1",
      "103": "1",
      "135": "1",
      "117": "1",
      "121": "1",
      "55": "1",
      "183": "1",
      "115": "1",
      "123": "1"
    },
    "7": {
      "81": "1",
      "93": "1",
      "145": "1",
      "157": "1",
      "21": "1",
      "25": "1",
      "213": "1",
      "217": "1",
      "39": "1",
      "199": "1",
      "114": "1",
      "124": "1",
      "70": "1",
      "166": "1",
      "72": "1",
      "168": "1",
      "100": "1",
      "106": "1",
      "132": "1",
      "138": "1",
      "102": "1",
      "104": "1",
      "134": "1",
      "136": "1"
    },
    "8": {
      "97": "1",
      "109": "1",
      "129": "1",
      "141": "1",
      "22": "1",
      "214": "1",
      "24": "1",
      "216": "1",
      "83": "1",
      "91": "1",
      "147": "1",
      "155": "1",
      "53": "1",
      "57": "1",
      "181": "1",
      "185": "1",
      "87": "1",
      "119": "1",
      "151": "1",
      "117": "1",
      "121": "1"
    }
  },
  "GoldTileCount": 0,
  "TileItemArray": [],
  "TotalItemNum": 15,
  "MoveVect": [
    0.0,
    0.0
  ],
  "TileTotalNum": 0,
  "TileLevelHardType": "Normal",
  "TotalCount": 123
}