{
  "AllLayerTileDict": {
    "1": {
      "213": "1",
      "215": "1",
      "217": "1"
    },
    "2": {
      "197": "1",
      "199": "1",
      "201": "1"
    },
    "3": {
      "180": "1",
      "182": "1",
      "184": "1",
      "186": "1"
    },
    "4": {
      "164": "1",
      "166": "1",
      "168": "1",
      "170": "1"
    },
    "5": {
      "147": "1",
      "149": "1",
      "151": "1",
      "153": "1",
      "155": "1"
    },
    "6": {
      "130": "1",
      "132": "1",
      "134": "1",
      "136": "1",
      "138": "1",
      "140": "1"
    },
    "7": {
      "116": "1",
      "118": "1",
      "120": "1",
      "122": "1",
      "124": "1",
      "114": "1"
    },
    "8": {
      "97": "1",
      "99": "1",
      "101": "1",
      "103": "1",
      "105": "1",
      "107": "1",
      "109": "1"
    },
    "9": {
      "155": "1",
      "153": "1",
      "151": "1",
      "147": "1",
      "149": "1",
      "17": "1",
      "61": "1",
      "114": "1",
      "116": "1",
      "118": "1",
      "120": "1",
      "122": "1",
      "124": "1"
    },
    "10": {
      "18": "1",
      "60": "1",
      "164": "1",
      "133": "1",
      "139": "1",
      "137": "1",
      "135": "1",
      "131": "1",
      "166": "1",
      "168": "1",
      "170": "1"
    },
    "11": {
      "19": "1",
      "59": "1",
      "185": "1",
      "183": "1",
      "181": "1",
      "154": "1",
      "152": "1",
      "150": "1",
      "148": "1"
    },
    "12": {
      "20": "1",
      "58": "1",
      "200": "1",
      "198": "1",
      "169": "1",
      "167": "1",
      "165": "1"
    },
    "13": {
      "21": "1",
      "57": "1",
      "215": "1",
      "184": "1",
      "182": "1"
    },
    "14": {
      "22": "1",
      "56": "1"
    },
    "15": {
      "23": "1",
      "55": "1"
    },
    "16": {
      "24": "1",
      "54": "1"
    },
    "17": {
      "25": "1",
      "53": "1"
    },
    "18": {
      "26": "1",
      "52": "1"
    },
    "19": {
      "27": "1",
      "51": "1"
    },
    "20": {
      "28": "1",
      "50": "1"
    },
    "21": {
      "29": "1",
      "49": "1",
      "161": "1",
      "211": "1",
      "193": "1",
      "173": "1",
      "205": "1",
      "219": "1"
    }
  },
  "GoldTileCount": 0,
  "TileItemArray": [
    7,
    8,
    9,
    10,
    11,
    12,
    14,
    16
  ],
  "TotalItemNum": 8,
  "MoveVect": [
    0.0,
    0.0
  ],
  "TileTotalNum": 0,
  "TileLevelHardType": "Normal",
  "TotalCount": 105
}