{
  "AllLayerTileDict": {
    "1": {
      "23": "1",
      "18": "1",
      "28": "1"
    },
    "2": {
      "34": "1",
      "39": "1",
      "44": "1"
    },
    "3": {
      "51": "1",
      "55": "1",
      "59": "1"
    },
    "4": {
      "68": "1",
      "71": "1",
      "74": "1"
    },
    "5": {
      "85": "1",
      "87": "1",
      "89": "1"
    },
    "6": {
      "102": "1",
      "104": "1"
    },
    "7": {
      "119": "1",
      "213": "1",
      "215": "1",
      "217": "1"
    },
    "8": {
      "196": "1",
      "198": "1",
      "200": "1",
      "202": "1"
    },
    "9": {
      "179": "1",
      "181": "1",
      "183": "1",
      "185": "1",
      "187": "1"
    },
    "10": {
      "162": "1",
      "164": "1",
      "166": "1",
      "168": "1",
      "170": "1",
      "172": "1"
    },
    "11": {
      "145": "1",
      "147": "1",
      "149": "1",
      "153": "1",
      "155": "1",
      "157": "1"
    },
    "12": {
      "129": "1",
      "131": "1",
      "139": "1",
      "141": "1",
      "161": "1",
      "173": "1"
    },
    "13": {
      "113": "1",
      "115": "1",
      "123": "1",
      "125": "1",
      "177": "1",
      "189": "1"
    },
    "14": {
      "97": "1",
      "109": "1",
      "193": "1",
      "205": "1"
    },
    "15": {
      "93": "1",
      "81": "1",
      "209": "1",
      "221": "1"
    },
    "16": {
      "194": "1",
      "204": "1",
      "163": "1",
      "171": "1",
      "132": "1",
      "138": "1",
      "165": "1",
      "167": "1",
      "169": "1",
      "196": "1",
      "198": "1",
      "200": "1",
      "202": "1"
    },
    "17": {
      "178": "1",
      "180": "1",
      "182": "1",
      "184": "1",
      "186": "1",
      "188": "1",
      "147": "1",
      "149": "1",
      "151": "1",
      "153": "1",
      "155": "1"
    },
    "18": {
      "163": "1",
      "165": "1",
      "167": "1",
      "169": "1",
      "171": "1",
      "195": "1",
      "203": "1"
    }
  },
  "TileItemArray": [],
  "TotalItemNum": 13,
  "MoveVect": [
    0.0,
    0.0
  ],
  "TileTotalNum": 0,
  "TileLevelHardType": "Normal",
  "TotalCount": 93
}