{
  "AllLayerTileDict": {
    "1": {
      "23": "1",
      "215": "1",
      "57": "1",
      "185": "1",
      "53": "1",
      "181": "1",
      "83": "1",
      "147": "1",
      "91": "1",
      "155": "1",
      "113": "1",
      "125": "1"
    },
    "2": {
      "199": "1",
      "114": "1",
      "124": "1",
      "70": "1",
      "72": "1",
      "166": "1",
      "168": "1",
      "100": "1",
      "106": "1",
      "132": "1",
      "138": "1",
      "39": "1",
      "118": "1",
      "120": "1"
    },
    "3": {
      "55": "1",
      "183": "1",
      "85": "1",
      "149": "1",
      "89": "1",
      "153": "1",
      "115": "1",
      "123": "1",
      "117": "1",
      "87": "1",
      "121": "1",
      "151": "1",
      "181": "1",
      "185": "1",
      "53": "1",
      "57": "1",
      "119": "1"
    },
    "4": {
      "70": "1",
      "166": "1",
      "72": "1",
      "168": "1",
      "132": "1",
      "138": "1",
      "100": "1",
      "106": "1",
      "102": "1",
      "104": "1",
      "134": "1",
      "136": "1",
      "68": "1",
      "74": "1"
    },
    "5": {
      "149": "1",
      "151": "1",
      "153": "1",
      "118": "1",
      "120": "1",
      "85": "1",
      "87": "1",
      "89": "1",
      "83": "1",
      "91": "1",
      "147": "1",
      "155": "1",
      "181": "1",
      "183": "1",
      "185": "1",
      "53": "1",
      "55": "1",
      "57": "1",
      "51": "1",
      "59": "1",
      "116": "1",
      "122": "1",
      "179": "1",
      "187": "1"
    }
  },
  "GoldTileCount": 0,
  "TileItemArray": [],
  "TotalItemNum": 15,
  "MoveVect": [
    0.0,
    0.0
  ],
  "TileTotalNum": 0,
  "TileLevelHardType": "Normal",
  "TotalCount": 81
}