{
  "AllLayerTileDict": {
    "1": {
      "17": "1",
      "187": "1",
      "157": "1",
      "155": "1",
      "217": "1",
      "185": "1",
      "153": "1",
      "29": "1",
      "209": "1"
    },
    "2": {
      "34": "1",
      "204": "1",
      "172": "1",
      "140": "1",
      "202": "1",
      "200": "1",
      "168": "1",
      "136": "1",
      "138": "1",
      "44": "1",
      "194": "1"
    },
    "3": {
      "49": "1",
      "187": "1",
      "185": "1",
      "183": "1",
      "151": "1",
      "119": "1",
      "121": "1",
      "123": "1",
      "155": "1",
      "61": "1",
      "211": "1",
      "19": "1"
    },
    "4": {
      "34": "1",
      "170": "1",
      "168": "1",
      "166": "1",
      "134": "1",
      "102": "1",
      "104": "1",
      "106": "1",
      "138": "1",
      "164": "1",
      "74": "1",
      "66": "1",
      "36": "1",
      "194": "1",
      "44": "1"
    },
    "5": {
      "153": "1",
      "151": "1",
      "149": "1",
      "117": "1",
      "85": "1",
      "87": "1",
      "89": "1",
      "121": "1",
      "119": "1",
      "91": "1",
      "181": "1",
      "183": "1",
      "123": "1",
      "51": "1",
      "83": "1",
      "53": "1",
      "179": "1",
      "59": "1"
    },
    "6": {
      "72": "1",
      "104": "1",
      "102": "1",
      "70": "1",
      "132": "1",
      "100": "1",
      "134": "1",
      "136": "1",
      "106": "1",
      "166": "1",
      "168": "1",
      "138": "1",
      "170": "1",
      "74": "1",
      "164": "1",
      "198": "1",
      "108": "1",
      "76": "1",
      "196": "1",
      "68": "1",
      "200": "1",
      "140": "1",
      "202": "1",
      "172": "1",
      "204": "1"
    }
  },
  "GoldTileCount": 0,
  "TileItemArray": [],
  "TotalItemNum": 15,
  "MoveVect": [
    0.0,
    0.0
  ],
  "TileTotalNum": 0,
  "TileLevelHardType": "Normal",
  "TotalCount": 90
}