{
  "AllLayerTileDict": {
    "1": {
      "23": "1",
      "21": "1",
      "81": "1",
      "113": "1",
      "17": "-2"
    },
    "2": {
      "37": "1",
      "39": "1",
      "82": "1",
      "114": "1",
      "17": "-2"
    },
    "3": {
      "83": "1",
      "115": "1",
      "53": "1",
      "55": "1",
      "17": "-2"
    },
    "4": {
      "68": "1",
      "100": "1",
      "132": "1",
      "70": "1",
      "72": "1",
      "17": "-2"
    },
    "5": {
      "117": "1",
      "85": "1",
      "87": "1",
      "17": "-2"
    },
    "6": {
      "102": "1",
      "17": "-2",
      "134": "1",
      "166": "1",
      "198": "1",
      "200": "1",
      "202": "1",
      "204": "1",
      "172": "1",
      "140": "1",
      "108": "1",
      "106": "1",
      "104": "1",
      "136": "1",
      "168": "1",
      "170": "1",
      "138": "1"
    },
    "7": {
      "119": "1",
      "17": "-2",
      "151": "1",
      "183": "1",
      "185": "1",
      "153": "1",
      "121": "1",
      "123": "1",
      "155": "1",
      "187": "1",
      "215": "1",
      "217": "1",
      "219": "1",
      "221": "1",
      "189": "1",
      "157": "1",
      "125": "1"
    },
    "8": {
      "134": "1",
      "104": "1",
      "136": "1",
      "17": "-2"
    },
    "9": {
      "149": "1",
      "89": "1",
      "151": "1",
      "153": "1",
      "121": "1",
      "119": "1",
      "17": "-2"
    },
    "10": {
      "164": "1",
      "74": "1",
      "166": "1",
      "168": "1",
      "170": "1",
      "138": "1",
      "106": "1",
      "104": "1",
      "136": "1",
      "134": "1",
      "17": "-2"
    },
    "11": {
      "179": "1",
      "59": "1",
      "181": "1",
      "183": "1",
      "185": "1",
      "187": "1",
      "155": "1",
      "123": "1",
      "91": "1",
      "89": "1",
      "121": "1",
      "153": "1",
      "149": "1",
      "151": "1",
      "119": "1"
    },
    "12": {
      "194": "1",
      "44": "1",
      "76": "1",
      "108": "1",
      "140": "1",
      "172": "1",
      "204": "1",
      "202": "1",
      "200": "1",
      "198": "1",
      "196": "1",
      "74": "1",
      "106": "1",
      "138": "1",
      "170": "1",
      "168": "1",
      "166": "1",
      "164": "1",
      "104": "1",
      "136": "1",
      "134": "1"
    },
    "13": {
      "211": "1",
      "61": "1",
      "93": "1",
      "125": "1",
      "157": "1",
      "189": "1",
      "221": "1",
      "219": "1",
      "217": "1",
      "215": "1",
      "213": "1",
      "91": "1",
      "123": "1",
      "187": "1",
      "155": "1",
      "185": "1",
      "183": "1",
      "181": "1",
      "151": "1",
      "153": "1",
      "121": "1"
    },
    "14": {
      "196": "1",
      "76": "1"
    },
    "15": {
      "181": "1",
      "91": "1"
    },
    "16": {
      "166": "1",
      "106": "1"
    },
    "17": {
      "151": "1",
      "121": "1"
    },
    "18": {
      "136": "1"
    }
  },
  "GoldTileCount": 0,
  "TileItemArray": [],
  "TotalItemNum": 12,
  "MoveVect": [
    0.0,
    0.0
  ],
  "TileTotalNum": 0,
  "TileLevelHardType": "Normal",
  "TotalCount": 147
}