{
  "AllLayerTileDict": {
    "1": {
      "22": "-2",
      "24": "-2",
      "20": "-2",
      "26": "-2",
      "18": "-2",
      "28": "-2",
      "82": "1",
      "92": "1",
      "113": "1",
      "125": "1",
      "145": "1",
      "157": "1",
      "178": "1",
      "188": "1"
    },
    "2": {
      "22": "-2",
      "24": "-2",
      "20": "-2",
      "26": "-2",
      "18": "-2",
      "28": "-2",
      "83": "1",
      "114": "1",
      "146": "1",
      "187": "1",
      "179": "1",
      "156": "1",
      "124": "1",
      "91": "1"
    },
    "3": {
      "22": "-2",
      "24": "-2",
      "20": "-2",
      "26": "-2",
      "18": "-2",
      "28": "-2",
      "84": "1",
      "115": "1",
      "147": "1",
      "90": "1",
      "123": "1",
      "155": "1",
      "180": "1",
      "186": "1"
    },
    "4": {
      "22": "-2",
      "24": "-2",
      "20": "-2",
      "26": "-2",
      "85": "1",
      "116": "1",
      "148": "1",
      "181": "1",
      "183": "1",
      "185": "1",
      "154": "1",
      "122": "1",
      "89": "1",
      "87": "1",
      "118": "1",
      "120": "1",
      "150": "1",
      "152": "1"
    },
    "5": {
      "22": "-2",
      "24": "-2",
      "86": "1",
      "88": "1",
      "117": "1",
      "149": "1",
      "121": "1",
      "153": "1",
      "182": "1",
      "184": "1",
      "151": "1",
      "119": "1",
      "139": "1",
      "131": "1",
      "215": "1",
      "171": "1",
      "163": "1",
      "213": "1",
      "217": "1"
    },
    "6": {
      "22": "-2",
      "24": "-2",
      "87": "1",
      "166": "1",
      "199": "1",
      "134": "1",
      "168": "1",
      "136": "1",
      "197": "1",
      "201": "1",
      "132": "1",
      "138": "1",
      "130": "1",
      "164": "1",
      "162": "1",
      "140": "1",
      "170": "1",
      "172": "1",
      "101": "1",
      "105": "1"
    },
    "7": {
      "102": "1",
      "104": "1",
      "147": "1",
      "133": "1",
      "135": "1",
      "137": "1",
      "155": "1",
      "165": "1",
      "167": "1",
      "169": "1",
      "198": "1",
      "200": "1"
    }
  },
  "GoldTileCount": 0,
  "TileItemArray": [],
  "TotalItemNum": 14,
  "MoveVect": [
    0.0,
    0.0
  ],
  "TileTotalNum": 0,
  "TileLevelHardType": "Normal",
  "TotalCount": 111
}