{
  "AllLayerTileDict": {
    "1": {
      "116": "1",
      "122": "1"
    },
    "2": {
      "99": "1",
      "107": "1",
      "101": "1",
      "105": "1",
      "133": "1",
      "137": "1",
      "131": "1",
      "139": "1"
    },
    "3": {
      "84": "1",
      "148": "1",
      "90": "1",
      "154": "1",
      "86": "1",
      "150": "1",
      "88": "1",
      "152": "1",
      "116": "1",
      "122": "1"
    },
    "4": {
      "67": "1",
      "163": "1",
      "69": "1",
      "165": "1",
      "71": "1",
      "167": "1",
      "73": "1",
      "169": "1",
      "75": "1",
      "107": "1",
      "99": "1",
      "139": "1",
      "131": "1",
      "171": "1"
    },
    "5": {
      "50": "1",
      "52": "1",
      "180": "1",
      "54": "1",
      "182": "1",
      "56": "1",
      "184": "1",
      "58": "1",
      "186": "1",
      "60": "1",
      "92": "1",
      "82": "1",
      "124": "1",
      "114": "1",
      "156": "1",
      "146": "1",
      "188": "1",
      "178": "1"
    },
    "6": {
      "33": "1",
      "193": "1",
      "45": "1",
      "205": "1",
      "65": "1",
      "161": "1",
      "77": "1",
      "173": "1",
      "67": "1",
      "163": "1",
      "75": "1",
      "171": "1",
      "35": "1",
      "195": "1",
      "43": "1",
      "203": "1",
      "71": "1",
      "115": "1",
      "123": "1",
      "167": "1"
    },
    "7": {
      "55": "1",
      "183": "1",
      "86": "1",
      "150": "1",
      "88": "1",
      "152": "1",
      "100": "1",
      "106": "1",
      "132": "1",
      "138": "1",
      "114": "1",
      "124": "1",
      "50": "1",
      "60": "1",
      "178": "1",
      "188": "1"
    },
    "8": {
      "33": "1",
      "193": "1",
      "45": "1",
      "205": "1",
      "35": "1",
      "195": "1",
      "43": "1",
      "203": "1",
      "67": "1",
      "163": "1",
      "75": "1",
      "171": "1",
      "65": "1",
      "161": "1",
      "77": "1",
      "173": "1",
      "39": "1",
      "71": "1",
      "113": "1",
      "199": "1",
      "167": "1",
      "115": "1",
      "123": "1",
      "125": "1",
      "105": "1",
      "137": "1",
      "101": "1",
      "133": "1",
      "119": "1"
    }
  },
  "GoldTileCount": 0,
  "TileItemArray": [],
  "TotalItemNum": 12,
  "MoveVect": [
    0.0,
    0.0
  ],
  "TileTotalNum": 0,
  "TileLevelHardType": "Normal",
  "TotalCount": 117
}