{
  "AllLayerTileDict": {
    "1": {
      "102": "1",
      "134": "1",
      "104": "1",
      "136": "1"
    },
    "2": {
      "85": "1",
      "117": "1",
      "149": "1",
      "151": "1",
      "153": "1",
      "121": "1",
      "89": "1"
    },
    "3": {
      "68": "1",
      "100": "1",
      "132": "1",
      "164": "1",
      "166": "1",
      "168": "1",
      "170": "1",
      "138": "1",
      "106": "1",
      "74": "1"
    },
    "4": {
      "179": "1",
      "181": "1",
      "183": "1",
      "185": "1",
      "187": "1",
      "155": "1",
      "123": "1",
      "91": "1",
      "59": "1",
      "147": "1",
      "115": "1",
      "83": "1",
      "51": "1"
    },
    "5": {
      "194": "1",
      "196": "1",
      "198": "1",
      "200": "1",
      "202": "1",
      "204": "1",
      "172": "1",
      "140": "1",
      "108": "1",
      "76": "1",
      "44": "1",
      "162": "1",
      "130": "1",
      "98": "1",
      "66": "1",
      "34": "1"
    },
    "6": {
      "209": "1",
      "211": "1",
      "213": "1",
      "215": "1",
      "217": "1",
      "219": "1",
      "221": "1",
      "189": "1",
      "157": "1",
      "125": "1",
      "93": "1",
      "61": "1",
      "29": "1",
      "177": "1",
      "145": "1",
      "113": "1",
      "81": "1",
      "49": "1",
      "17": "1"
    },
    "7": {
      "194": "1",
      "162": "1",
      "130": "1",
      "98": "1",
      "66": "1",
      "34": "1",
      "204": "1",
      "172": "1",
      "140": "1",
      "108": "1",
      "76": "1",
      "44": "1",
      "196": "1",
      "198": "1",
      "200": "1",
      "202": "1",
      "52": "1",
      "58": "1",
      "85": "1",
      "89": "1",
      "118": "1",
      "120": "1",
      "151": "1"
    },
    "8": {
      "147": "1",
      "157": "1",
      "145": "1",
      "51": "1",
      "197": "1",
      "103": "1",
      "201": "1",
      "155": "1",
      "113": "1",
      "125": "1",
      "59": "1",
      "101": "1",
      "105": "1",
      "71": "1",
      "37": "1",
      "41": "1",
      "167": "1",
      "39": "1",
      "81": "1",
      "93": "1",
      "115": "1",
      "123": "1",
      "135": "1",
      "179": "1",
      "187": "1",
      "83": "1",
      "91": "1",
      "199": "1",
      "69": "1",
      "73": "1",
      "137": "1",
      "133": "1",
      "165": "1",
      "169": "1"
    }
  },
  "GoldTileCount": 0,
  "TileItemArray": [],
  "TotalItemNum": 10,
  "MoveVect": [
    0.0,
    0.0
  ],
  "TileTotalNum": 0,
  "TileLevelHardType": "Normal",
  "TotalCount": 126
}