{
  "AllLayerTileDict": {
    "1": {
      "17": "1",
      "29": "1",
      "113": "1",
      "125": "1",
      "209": "1",
      "221": "1"
    },
    "2": {
      "34": "1",
      "44": "1",
      "194": "1",
      "204": "1",
      "114": "1",
      "124": "1"
    },
    "3": {
      "51": "1",
      "59": "1",
      "115": "1",
      "123": "1",
      "179": "1",
      "187": "1"
    },
    "4": {
      "68": "1",
      "74": "1",
      "116": "1",
      "122": "1",
      "164": "1",
      "170": "1"
    },
    "5": {
      "85": "1",
      "89": "1",
      "117": "1",
      "121": "1",
      "149": "1",
      "153": "1",
      "87": "1",
      "151": "1",
      "119": "1"
    },
    "6": {
      "102": "1",
      "104": "1",
      "134": "1",
      "136": "1",
      "100": "1",
      "106": "1",
      "138": "1",
      "132": "1"
    },
    "7": {
      "103": "1",
      "117": "1",
      "121": "1",
      "71": "1",
      "135": "1",
      "89": "1",
      "85": "1",
      "149": "1",
      "153": "1",
      "167": "1"
    },
    "8": {
      "100": "1",
      "120": "1",
      "132": "1",
      "152": "1",
      "150": "1",
      "86": "1",
      "118": "1",
      "88": "1",
      "138": "1",
      "106": "1"
    },
    "9": {
      "38": "1",
      "200": "1",
      "168": "1",
      "70": "1",
      "102": "1",
      "136": "1",
      "134": "1",
      "104": "1"
    },
    "10": {
      "101": "1",
      "69": "1",
      "37": "1",
      "201": "1",
      "169": "1",
      "137": "1",
      "133": "1",
      "105": "1"
    },
    "11": {
      "100": "1",
      "68": "1",
      "36": "1",
      "202": "1",
      "170": "1",
      "138": "1",
      "132": "1",
      "106": "1"
    },
    "12": {
      "99": "1",
      "67": "1",
      "35": "1",
      "139": "1",
      "171": "1",
      "203": "1",
      "131": "1",
      "107": "1"
    },
    "13": {
      "98": "1",
      "66": "1",
      "34": "1",
      "140": "1",
      "172": "1",
      "204": "1",
      "130": "1",
      "108": "1"
    },
    "14": {
      "97": "1",
      "65": "1",
      "33": "1",
      "141": "1",
      "173": "1",
      "205": "1",
      "129": "1",
      "109": "1"
    },
    "15": {
      "49": "1",
      "51": "1",
      "53": "1",
      "81": "1",
      "83": "1",
      "85": "1",
      "157": "1",
      "155": "1",
      "153": "1",
      "189": "1",
      "187": "1",
      "185": "1",
      "151": "1",
      "183": "1",
      "55": "1",
      "87": "1",
      "115": "1",
      "117": "1",
      "123": "1",
      "121": "1",
      "119": "1",
      "113": "1",
      "125": "1"
    }
  },
  "GoldTileCount": 0,
  "TileItemArray": [],
  "TotalItemNum": 9,
  "MoveVect": [
    0.0,
    0.0
  ],
  "TileTotalNum": 0,
  "TileLevelHardType": "Normal",
  "TotalCount": 132
}