{
  "AllLayerTileDict": {
    "1": {
      "18": "1",
      "50": "1",
      "83": "1",
      "116": "1",
      "85": "1",
      "54": "1",
      "23": "1",
      "56": "1",
      "89": "1",
      "122": "1",
      "91": "1",
      "60": "1",
      "28": "1"
    },
    "2": {
      "33": "1",
      "105": "1",
      "45": "1",
      "66": "1",
      "72": "1",
      "76": "1",
      "99": "1",
      "107": "1",
      "132": "1",
      "138": "1",
      "101": "1",
      "70": "1",
      "39": "1"
    },
    "3": {
      "49": "1",
      "61": "1",
      "82": "1",
      "92": "1",
      "115": "1",
      "123": "1",
      "148": "1",
      "154": "1",
      "117": "1",
      "121": "1",
      "86": "1",
      "88": "1",
      "55": "1"
    },
    "4": {
      "65": "1",
      "77": "1",
      "98": "1",
      "108": "1",
      "131": "1",
      "139": "1",
      "164": "1",
      "170": "1",
      "133": "1",
      "137": "1",
      "102": "1",
      "104": "1",
      "71": "1"
    },
    "5": {
      "81": "1",
      "93": "1",
      "114": "1",
      "124": "1",
      "147": "1",
      "155": "1",
      "180": "1",
      "186": "1",
      "149": "1",
      "153": "1",
      "118": "1",
      "120": "1",
      "87": "1"
    },
    "6": {
      "97": "1",
      "109": "1",
      "130": "1",
      "140": "1",
      "163": "1",
      "171": "1",
      "196": "1",
      "202": "1",
      "165": "1",
      "169": "1",
      "134": "1",
      "136": "1",
      "103": "1"
    },
    "7": {
      "113": "1",
      "125": "1",
      "146": "1",
      "156": "1",
      "179": "1",
      "187": "1",
      "212": "1",
      "218": "1",
      "181": "1",
      "185": "1",
      "150": "1",
      "152": "1",
      "119": "1"
    },
    "8": {
      "129": "1",
      "141": "1",
      "162": "1",
      "172": "1",
      "195": "1",
      "203": "1",
      "197": "1",
      "201": "1",
      "166": "1",
      "168": "1",
      "135": "1"
    }
  },
  "GoldTileCount": 0,
  "TileItemArray": [],
  "TotalItemNum": 10,
  "MoveVect": [
    0.0,
    0.0
  ],
  "TileTotalNum": 0,
  "TileLevelHardType": "Normal",
  "TotalCount": 102
}