{
  "AllLayerTileDict": {
    "1": {
      "103": "1",
      "135": "1",
      "117": "1",
      "121": "1"
    },
    "2": {
      "86": "1",
      "150": "1",
      "88": "1",
      "152": "1",
      "100": "1",
      "106": "1",
      "132": "1",
      "138": "1",
      "118": "1",
      "120": "1"
    },
    "3": {
      "69": "1",
      "165": "1",
      "71": "1",
      "167": "1",
      "73": "1",
      "169": "1",
      "83": "1",
      "91": "1",
      "115": "1",
      "123": "1",
      "147": "1",
      "155": "1",
      "101": "1",
      "103": "1",
      "105": "1",
      "137": "1",
      "135": "1",
      "133": "1"
    },
    "4": {
      "52": "1",
      "180": "1",
      "54": "1",
      "182": "1",
      "56": "1",
      "184": "1",
      "58": "1",
      "186": "1",
      "66": "1",
      "76": "1",
      "98": "1",
      "108": "1",
      "130": "1",
      "140": "1",
      "162": "1",
      "172": "1",
      "102": "1",
      "134": "1",
      "136": "1",
      "104": "1"
    },
    "5": {
      "35": "1",
      "195": "1",
      "37": "1",
      "197": "1",
      "39": "1",
      "199": "1",
      "41": "1",
      "201": "1",
      "43": "1",
      "203": "1",
      "61": "1",
      "49": "1",
      "93": "1",
      "81": "1",
      "125": "1",
      "113": "1",
      "157": "1",
      "145": "1",
      "189": "1",
      "177": "1",
      "85": "1",
      "117": "1",
      "149": "1",
      "151": "1",
      "153": "1",
      "121": "1",
      "89": "1",
      "87": "1",
      "119": "1"
    },
    "6": {
      "18": "1",
      "210": "1",
      "20": "1",
      "212": "1",
      "22": "1",
      "214": "1",
      "24": "1",
      "216": "1",
      "26": "1",
      "218": "1",
      "28": "1",
      "220": "1",
      "60": "1",
      "50": "1",
      "92": "1",
      "82": "1",
      "124": "1",
      "114": "1",
      "156": "1",
      "146": "1",
      "188": "1",
      "178": "1",
      "68": "1",
      "100": "1",
      "132": "1",
      "164": "1",
      "166": "1",
      "168": "1",
      "170": "1",
      "138": "1",
      "106": "1",
      "74": "1",
      "72": "1",
      "70": "1",
      "134": "1",
      "104": "1"
    }
  },
  "GoldTileCount": 0,
  "TileItemArray": [],
  "TotalItemNum": 9,
  "MoveVect": [
    0.0,
    0.0
  ],
  "TileTotalNum": 0,
  "TileLevelHardType": "Normal",
  "TotalCount": 117
}