{
  "AllLayerTileDict": {
    "1": {
      "66": "1",
      "76": "1",
      "84": "1",
      "154": "1",
      "162": "1",
      "172": "1"
    },
    "2": {
      "49": "1",
      "77": "1",
      "99": "1",
      "109": "1",
      "129": "1",
      "139": "1",
      "161": "1",
      "189": "1"
    },
    "3": {
      "65": "1",
      "92": "1",
      "114": "1",
      "124": "1",
      "146": "1",
      "173": "1"
    },
    "4": {
      "55": "1",
      "81": "1",
      "93": "1",
      "99": "1",
      "139": "1",
      "145": "1",
      "157": "1",
      "183": "1"
    },
    "5": {
      "72": "1",
      "98": "1",
      "105": "1",
      "107": "1",
      "109": "1",
      "129": "1",
      "131": "1",
      "133": "1",
      "140": "1",
      "166": "1"
    },
    "6": {
      "83": "1",
      "85": "1",
      "89": "1",
      "113": "1",
      "115": "1",
      "123": "1",
      "125": "1",
      "149": "1",
      "153": "1",
      "155": "1"
    },
    "7": {
      "28": "1",
      "100": "1",
      "106": "1",
      "108": "1",
      "130": "1",
      "132": "1",
      "138": "1",
      "210": "1"
    },
    "8": {
      "27": "1",
      "75": "1",
      "88": "1",
      "93": "1",
      "115": "1",
      "123": "1",
      "145": "1",
      "150": "1",
      "163": "1",
      "211": "1"
    },
    "9": {
      "19": "1",
      "28": "1",
      "76": "1",
      "89": "1",
      "107": "1",
      "117": "1",
      "121": "1",
      "131": "1",
      "149": "1",
      "162": "1",
      "210": "1",
      "219": "1"
    },
    "10": {
      "18": "1",
      "45": "1",
      "52": "1",
      "59": "1",
      "88": "1",
      "86": "1",
      "106": "1",
      "119": "1",
      "132": "1",
      "152": "1",
      "150": "1",
      "179": "1",
      "186": "1",
      "193": "1",
      "220": "1"
    }
  },
  "GoldTileCount": 0,
  "TileItemArray": [],
  "TotalItemNum": 9,
  "MoveVect": [
    0.0,
    0.0
  ],
  "TileTotalNum": 0,
  "TileLevelHardType": "Normal",
  "TotalCount": 93
}