{
  "AllLayerTileDict": {
    "1": {
      "34": "1",
      "91": "1",
      "147": "1",
      "204": "1",
      "209": "0",
      "177": "0",
      "29": "-1",
      "61": "-1",
      "23": "-2",
      "215": "-3"
    },
    "2": {
      "50": "1",
      "105": "1",
      "107": "1",
      "131": "1",
      "133": "1",
      "188": "1",
      "209": "0",
      "177": "0",
      "29": "-1",
      "61": "-1",
      "23": "-2",
      "215": "-3"
    },
    "3": {
      "33": "1",
      "106": "1",
      "132": "1",
      "205": "1",
      "209": "0",
      "177": "0",
      "29": "-1",
      "61": "-1",
      "23": "-2",
      "215": "-3"
    },
    "4": {
      "17": "1",
      "49": "1",
      "99": "1",
      "107": "1",
      "131": "1",
      "139": "1",
      "189": "1",
      "221": "1",
      "209": "0",
      "177": "0",
      "29": "-1",
      "61": "-1",
      "23": "-2",
      "215": "-3"
    },
    "5": {
      "33": "1",
      "115": "1",
      "117": "1",
      "121": "1",
      "123": "1",
      "205": "1",
      "209": "0",
      "177": "0",
      "29": "-1",
      "61": "-1",
      "23": "-2",
      "215": "-3"
    },
    "6": {
      "49": "1",
      "98": "1",
      "108": "1",
      "116": "1",
      "122": "1",
      "130": "1",
      "140": "1",
      "189": "1",
      "209": "0",
      "177": "0",
      "29": "-1",
      "61": "-1",
      "23": "-2",
      "215": "-3"
    },
    "7": {
      "66": "1",
      "97": "1",
      "115": "1",
      "123": "1",
      "141": "1",
      "172": "1",
      "209": "0",
      "177": "0",
      "29": "-1",
      "61": "-1",
      "23": "-2",
      "215": "-3"
    },
    "8": {
      "17": "1",
      "49": "1",
      "114": "1",
      "124": "1",
      "189": "1",
      "221": "1",
      "209": "0",
      "177": "0",
      "29": "-1",
      "61": "-1",
      "23": "-2",
      "215": "-3"
    },
    "9": {
      "20": "1",
      "34": "1",
      "52": "1",
      "98": "1",
      "140": "1",
      "186": "1",
      "204": "1",
      "218": "1",
      "209": "0",
      "177": "0",
      "29": "-1",
      "61": "-1",
      "23": "-2",
      "215": "-3"
    },
    "10": {
      "35": "1",
      "97": "1",
      "115": "1",
      "123": "1",
      "141": "1",
      "203": "1",
      "209": "0",
      "177": "0",
      "29": "-1",
      "61": "-1"
    }
  },
  "GoldTileCount": 0,
  "TileItemArray": [],
  "TotalItemNum": 12,
  "MoveVect": [
    0.0,
    0.0
  ],
  "TileTotalNum": 0,
  "TileLevelHardType": "Normal",
  "TotalCount": 120
}