{
  "AllLayerTileDict": {
    "1": {
      "74": "1",
      "93": "1",
      "99": "1",
      "106": "1",
      "132": "1",
      "139": "1",
      "145": "1",
      "164": "1"
    },
    "2": {
      "90": "1",
      "108": "1",
      "116": "1",
      "122": "1",
      "130": "1",
      "148": "1"
    },
    "3": {
      "91": "1",
      "115": "1",
      "117": "1",
      "121": "1",
      "123": "1",
      "147": "1"
    },
    "4": {
      "104": "1",
      "106": "1",
      "132": "1",
      "134": "1"
    },
    "5": {
      "86": "1",
      "117": "1",
      "121": "1",
      "152": "1"
    },
    "6": {
      "19": "1",
      "50": "1",
      "68": "1",
      "82": "1",
      "101": "1",
      "103": "1",
      "106": "1",
      "114": "1",
      "124": "1",
      "132": "1",
      "135": "1",
      "137": "1",
      "156": "1",
      "170": "1",
      "188": "1",
      "219": "1"
    },
    "7": {
      "34": "1",
      "52": "1",
      "97": "1",
      "100": "1",
      "107": "1",
      "118": "1",
      "120": "1",
      "131": "1",
      "138": "1",
      "141": "1",
      "186": "1",
      "204": "1"
    },
    "8": {
      "49": "1",
      "67": "1",
      "81": "1",
      "90": "1",
      "117": "1",
      "121": "1",
      "148": "1",
      "157": "1",
      "171": "1",
      "189": "1"
    },
    "9": {
      "66": "1",
      "88": "1",
      "106": "1",
      "132": "1",
      "150": "1",
      "172": "1"
    },
    "10": {
      "51": "1",
      "82": "1",
      "105": "1",
      "133": "1",
      "156": "1",
      "187": "1"
    },
    "11": {
      "24": "1",
      "26": "1",
      "33": "1",
      "67": "1",
      "104": "1",
      "106": "1",
      "114": "1",
      "124": "1",
      "132": "1",
      "134": "1",
      "171": "1",
      "205": "1",
      "212": "1",
      "214": "1"
    },
    "12": {
      "18": "1",
      "25": "1",
      "83": "1",
      "115": "1",
      "117": "1",
      "121": "1",
      "123": "1",
      "155": "1",
      "213": "1",
      "220": "1"
    }
  },
  "GoldTileCount": 0,
  "TileItemArray": [],
  "TotalItemNum": 9,
  "MoveVect": [
    0.0,
    0.0
  ],
  "TileTotalNum": 0,
  "TileLevelHardType": "Normal",
  "TotalCount": 102
}