{
  "AllLayerTileDict": {
    "1": {
      "17": "-2",
      "29": "-2",
      "23": "-2",
      "36": "-2",
      "42": "-2",
      "113": "1",
      "145": "1",
      "177": "1",
      "209": "1",
      "120": "1",
      "221": "1",
      "125": "1",
      "216": "1"
    },
    "2": {
      "17": "-2",
      "29": "-2",
      "23": "-2",
      "36": "-2",
      "42": "-2",
      "114": "1",
      "146": "1",
      "178": "1",
      "210": "1",
      "136": "1",
      "217": "1",
      "205": "1",
      "124": "1"
    },
    "3": {
      "17": "-2",
      "29": "-2",
      "23": "-2",
      "36": "-2",
      "42": "-2",
      "115": "1",
      "147": "1",
      "179": "1",
      "211": "1",
      "218": "1",
      "189": "1",
      "123": "1",
      "152": "1"
    },
    "4": {
      "17": "-2",
      "29": "-2",
      "23": "-2",
      "36": "-2",
      "42": "-2",
      "116": "1",
      "148": "1",
      "180": "1",
      "212": "1",
      "122": "1",
      "168": "1",
      "219": "1",
      "173": "1"
    },
    "5": {
      "17": "-2",
      "29": "-2",
      "23": "-2",
      "36": "-2",
      "42": "-2",
      "117": "1",
      "149": "1",
      "181": "1",
      "213": "1",
      "184": "1",
      "220": "1",
      "157": "1",
      "121": "1"
    },
    "6": {
      "17": "-2",
      "29": "-2",
      "23": "-2",
      "36": "-2",
      "42": "-2",
      "118": "1",
      "150": "1",
      "182": "1",
      "214": "1",
      "200": "1",
      "221": "1",
      "141": "1",
      "120": "1"
    },
    "7": {
      "17": "-2",
      "29": "-2",
      "23": "-2",
      "36": "-2",
      "42": "-2",
      "125": "1",
      "216": "1"
    },
    "8": {
      "17": "-2",
      "29": "-2"
    }
  },
  "GoldTileCount": 0,
  "GasolineCount": 0,
  "TileItemArray": [],
  "TotalItemNum": 10,
  "MoveVect": [
    0.0,
    0.0
  ],
  "TileTotalNum": 0,
  "TileLevelHardType": "Normal",
  "TotalCount": 87
}