{
  "AllLayerTileDict": {
    "1": {
      "22": "1",
      "24": "1",
      "28": "1",
      "20": "1",
      "26": "1",
      "18": "1"
    },
    "2": {
      "42": "1",
      "38": "1",
      "40": "1",
      "36": "1",
      "45": "1",
      "33": "1"
    },
    "3": {
      "52": "1",
      "54": "1",
      "56": "1",
      "58": "1",
      "188": "1",
      "178": "1",
      "60": "1",
      "50": "1"
    },
    "4": {
      "68": "1",
      "70": "1",
      "72": "1",
      "74": "1",
      "100": "1",
      "102": "1",
      "106": "1",
      "104": "1",
      "65": "1",
      "77": "1",
      "205": "1",
      "173": "1",
      "193": "1",
      "161": "1"
    },
    "5": {
      "84": "1",
      "86": "1",
      "88": "1",
      "90": "1",
      "116": "1",
      "118": "1",
      "120": "1",
      "122": "1",
      "82": "1",
      "92": "1",
      "178": "1",
      "188": "1"
    },
    "6": {
      "100": "1",
      "102": "1",
      "104": "1",
      "106": "1",
      "132": "1",
      "134": "1",
      "136": "1",
      "138": "1",
      "97": "1",
      "109": "1",
      "161": "1",
      "193": "1",
      "173": "1",
      "205": "1"
    },
    "7": {
      "116": "1",
      "118": "1",
      "120": "1",
      "122": "1",
      "148": "1",
      "150": "1",
      "152": "1",
      "154": "1",
      "178": "1",
      "188": "1"
    },
    "8": {
      "132": "1",
      "134": "1",
      "136": "1",
      "138": "1",
      "164": "1",
      "166": "1",
      "168": "1",
      "170": "1"
    },
    "9": {
      "148": "1",
      "150": "1",
      "152": "1",
      "154": "1",
      "180": "1",
      "182": "1",
      "184": "1",
      "186": "1"
    },
    "10": {
      "164": "1",
      "166": "1",
      "168": "1",
      "170": "1",
      "196": "1",
      "198": "1",
      "200": "1",
      "202": "1"
    },
    "11": {
      "180": "1",
      "182": "1",
      "184": "1",
      "186": "1",
      "212": "1",
      "214": "1",
      "216": "1",
      "218": "1"
    }
  },
  "GoldTileCount": 0,
  "GasolineCount": 0,
  "TileItemArray": [],
  "TotalItemNum": 10,
  "MoveVect": [
    0.0,
    0.0
  ],
  "TileTotalNum": 0,
  "TileLevelHardType": "Normal",
  "TotalCount": 102
}