{
  "AllLayerTileDict": {
    "1": {
      "23": "1",
      "53": "1",
      "83": "1",
      "57": "1",
      "91": "1",
      "125": "1",
      "113": "1",
      "183": "1",
      "151": "1",
      "105": "1",
      "65": "-3",
      "215": "1",
      "101": "1",
      "77": "-3",
      "35": "-3",
      "43": "-3"
    },
    "2": {
      "38": "1",
      "40": "1",
      "68": "1",
      "74": "1",
      "98": "1",
      "108": "1",
      "122": "1",
      "116": "1",
      "134": "1",
      "136": "1",
      "198": "1",
      "200": "1",
      "65": "-3",
      "77": "-3",
      "35": "-3",
      "43": "-3"
    },
    "3": {
      "55": "1",
      "65": "-3",
      "77": "-3",
      "115": "1",
      "123": "1",
      "215": "1",
      "183": "1",
      "35": "-3",
      "43": "-3",
      "151": "1",
      "119": "1"
    },
    "4": {
      "200": "1",
      "198": "1",
      "65": "-3",
      "77": "-3",
      "35": "-3",
      "43": "-3",
      "71": "1",
      "136": "1",
      "134": "1"
    },
    "5": {
      "215": "1",
      "183": "1",
      "65": "-3",
      "77": "-3",
      "35": "-3",
      "43": "-3",
      "87": "1",
      "151": "1",
      "119": "1"
    },
    "6": {
      "65": "-3",
      "77": "-3",
      "35": "-3",
      "43": "-3",
      "136": "1",
      "134": "1",
      "200": "1",
      "198": "1"
    },
    "7": {
      "181": "1",
      "149": "1",
      "153": "1",
      "213": "1",
      "185": "1",
      "217": "1"
    },
    "8": {
      "180": "1",
      "148": "1",
      "212": "1",
      "154": "1",
      "186": "1",
      "218": "1"
    },
    "9": {
      "179": "1",
      "147": "1",
      "211": "1",
      "155": "1",
      "187": "1",
      "219": "1"
    },
    "10": {
      "188": "1",
      "156": "1",
      "220": "1",
      "146": "1",
      "178": "1",
      "210": "1"
    },
    "11": {
      "157": "1",
      "189": "1",
      "221": "1",
      "145": "1",
      "177": "1",
      "209": "1"
    }
  },
  "GoldTileCount": 0,
  "GasolineCount": 0,
  "TileItemArray": [],
  "TotalItemNum": 10,
  "MoveVect": [
    0.0,
    0.0
  ],
  "TileTotalNum": 0,
  "TileLevelHardType": "Normal",
  "TotalCount": 99
}