{
  "AllLayerTileDict": {
    "1": {
      "145": "1",
      "147": "1",
      "149": "1",
      "153": "1",
      "155": "1",
      "157": "1",
      "135": "1",
      "17": "-2",
      "20": "-2",
      "23": "-2",
      "26": "-2",
      "29": "-2"
    },
    "2": {
      "161": "1",
      "163": "1",
      "165": "1",
      "118": "1",
      "120": "1",
      "17": "-2",
      "20": "-2",
      "23": "-2",
      "26": "-2",
      "29": "-2",
      "169": "1",
      "171": "1",
      "173": "1"
    },
    "3": {
      "157": "1",
      "155": "1",
      "153": "1",
      "101": "1",
      "103": "1",
      "105": "1",
      "17": "-2",
      "20": "-2",
      "23": "-2",
      "26": "-2",
      "29": "-2",
      "145": "1",
      "147": "1",
      "149": "1"
    },
    "4": {
      "165": "1",
      "163": "1",
      "161": "1",
      "173": "1",
      "171": "1",
      "169": "1",
      "84": "1",
      "86": "1",
      "88": "1",
      "90": "1",
      "17": "-2",
      "20": "-2",
      "23": "-2",
      "26": "-2",
      "29": "-2"
    },
    "5": {
      "67": "1",
      "69": "1",
      "71": "1",
      "73": "1",
      "75": "1",
      "17": "-2",
      "20": "-2",
      "23": "-2",
      "26": "-2",
      "29": "-2",
      "145": "1",
      "147": "1",
      "149": "1",
      "153": "1",
      "155": "1",
      "157": "1"
    },
    "6": {
      "173": "1",
      "171": "1",
      "169": "1",
      "165": "1",
      "163": "1",
      "161": "1",
      "17": "-2",
      "20": "-2",
      "23": "-2",
      "26": "-2",
      "29": "-2"
    },
    "7": {
      "177": "1",
      "179": "1",
      "181": "1",
      "185": "1",
      "187": "1",
      "189": "1"
    },
    "8": {
      "193": "1",
      "195": "1",
      "197": "1",
      "201": "1",
      "203": "1",
      "205": "1"
    },
    "9": {
      "209": "1",
      "211": "1",
      "213": "1",
      "217": "1",
      "219": "1",
      "221": "1"
    }
  },
  "GoldTileCount": 0,
  "TileItemArray": [],
  "TotalItemNum": 12,
  "MoveVect": [
    0.0,
    0.0
  ],
  "TileTotalNum": 0,
  "TileLevelRandomLayerDataList": [],
  "TileLevelHardType": "Normal",
  "TotalCount": 99
}