{
  "AllLayerTileDict": {
    "1": {
      "153": "1",
      "179": "1",
      "213": "1",
      "187": "1",
      "217": "1",
      "23": "-2",
      "65": "1",
      "77": "1",
      "29": "-2",
      "26": "-2",
      "17": "-2",
      "20": "-2",
      "149": "1",
      "119": "1"
    },
    "2": {
      "26": "-2",
      "164": "1",
      "200": "1",
      "170": "1",
      "198": "1",
      "136": "1",
      "134": "1",
      "20": "-2",
      "23": "-2",
      "76": "1",
      "66": "1",
      "17": "-2",
      "29": "-2",
      "162": "1",
      "194": "1",
      "172": "1",
      "204": "1"
    },
    "3": {
      "26": "-2",
      "121": "1",
      "147": "1",
      "155": "1",
      "117": "1",
      "20": "-2",
      "67": "1",
      "23": "-2",
      "75": "1",
      "181": "1",
      "185": "1",
      "183": "1",
      "17": "-2",
      "29": "-2",
      "145": "1",
      "177": "1",
      "209": "1",
      "157": "1",
      "189": "1",
      "221": "1"
    },
    "4": {
      "26": "-2",
      "104": "1",
      "132": "1",
      "138": "1",
      "102": "1",
      "74": "1",
      "68": "1",
      "20": "-2",
      "23": "-2",
      "166": "1",
      "168": "1",
      "17": "-2",
      "29": "-2",
      "130": "1",
      "140": "1",
      "210": "1",
      "220": "1"
    },
    "5": {
      "123": "1",
      "113": "1",
      "125": "1",
      "26": "-2",
      "20": "-2",
      "17": "-2",
      "29": "-2",
      "73": "1",
      "23": "-2",
      "69": "1",
      "115": "1"
    },
    "6": {
      "109": "1",
      "99": "1",
      "107": "1",
      "26": "-2",
      "20": "-2",
      "17": "-2",
      "29": "-2",
      "23": "-2",
      "72": "1",
      "70": "1",
      "97": "1"
    }
  },
  "GoldTileCount": 0,
  "TileItemArray": [],
  "TotalItemNum": 14,
  "MoveVect": [
    0.0,
    0.0
  ],
  "TileTotalNum": 0,
  "TileLevelRandomLayerDataList": [
    {
      "Layer1": 1,
      "Layer2": 3,
      "TileTypeNum": 14
    },
    {
      "Layer1": 4,
      "Layer2": 6,
      "TileTypeNum": 11
    }
  ],
  "TileLevelHardType": "Normal",
  "TotalCount": 90
}