{
  "AllLayerTileDict": {
    "1": {
      "34": 1,
      "44": 1,
      "194": 1,
      "204": 1,
      "36": 1,
      "196": 1,
      "42": 1,
      "202": 1,
      "69": 1,
      "73": 1,
      "101": 1,
      "105": 1,
      "133": 1,
      "137": 1,
      "165": 1,
      "169": 1
    },
    "2": {
      "49": 1,
      "61": 1,
      "177": 1,
      "189": 1,
      "51": 1,
      "59": 1,
      "179": 1,
      "187": 1,
      "84": 1,
      "90": 1,
      "148": 1,
      "154": 1,
      "116": 1,
      "122": 1
    },
    "3": {
      "65": 1,
      "77": 1,
      "67": 1,
      "75": 1,
      "99": 1,
      "107": 1,
      "131": 1,
      "139": 1,
      "163": 1,
      "171": 1,
      "161": 1,
      "173": 1,
      "117": 1,
      "119": 1,
      "121": 1,
      "87": 1,
      "55": 1,
      "23": 1,
      "151": 1,
      "183": 1,
      "215": 1
    },
    "4": {
      "38": 1,
      "40": 1,
      "71": 1,
      "103": 1,
      "135": 1,
      "167": 1,
      "199": 1,
      "101": 1,
      "133": 1,
      "105": 1,
      "137": 1,
      "68": 1,
      "74": 1,
      "164": 1,
      "170": 1,
      "66": 1,
      "76": 1,
      "162": 1,
      "172": 1,
      "130": 1,
      "98": 1,
      "108": 1,
      "140": 1
    },
    "5": {
      "52": 1,
      "58": 1,
      "50": 1,
      "60": 1,
      "81": 1,
      "93": 1,
      "113": 1,
      "125": 1,
      "145": 1,
      "157": 1,
      "178": 1,
      "188": 1,
      "180": 1,
      "186": 1,
      "149": 1,
      "153": 1,
      "117": 1,
      "121": 1,
      "85": 1,
      "89": 1,
      "55": 1,
      "87": 1,
      "119": 1,
      "151": 1,
      "183": 1
    }
  },
  "TileItemArray": [],
  "TotalItemNum": 8,
  "MoveVect": [
    0.0,
    0.0
  ],
  "TileTotalNum": 0,
  "TileLevelHardType": "Hard",
  "TotalCount": 99
}