{
  "AllLayerTileDict": {
    "1": {
      "34": 1,
      "44": 1,
      "194": 1,
      "204": 1,
      "68": 1,
      "74": 1,
      "100": 1,
      "106": 1,
      "132": 1,
      "138": 1,
      "164": 1,
      "170": 1
    },
    "2": {
      "51": 1,
      "59": 1,
      "83": 1,
      "91": 1,
      "115": 1,
      "123": 1,
      "147": 1,
      "155": 1,
      "179": 1,
      "187": 1,
      "69": 1,
      "73": 1,
      "117": 1,
      "121": 1,
      "165": 1,
      "169": 1
    },
    "3": {
      "68": 1,
      "74": 1,
      "100": 1,
      "106": 1,
      "132": 1,
      "138": 1,
      "164": 1,
      "170": 1,
      "102": 1,
      "104": 1,
      "134": 1,
      "136": 1,
      "34": 1,
      "44": 1,
      "194": 1,
      "204": 1
    },
    "4": {
      "51": 1,
      "59": 1,
      "85": 1,
      "87": 1,
      "89": 1,
      "115": 1,
      "123": 1,
      "147": 1,
      "155": 1,
      "149": 1,
      "153": 1,
      "151": 1,
      "179": 1,
      "187": 1,
      "119": 1
    },
    "5": {
      "68": 1,
      "74": 1,
      "102": 1,
      "104": 1,
      "132": 1,
      "138": 1,
      "134": 1,
      "136": 1,
      "164": 1,
      "170": 1
    },
    "6": {
      "85": 1,
      "89": 1,
      "119": 1,
      "149": 1,
      "153": 1
    },
    "7": {
      "102": 1,
      "104": 1,
      "134": 1,
      "136": 1,
      "68": 1,
      "74": 1,
      "164": 1,
      "170": 1,
      "138": 1,
      "132": 1,
      "100": 1,
      "106": 1,
      "70": 1,
      "72": 1,
      "166": 1,
      "168": 1
    }
  },
  "TileItemArray": [
    2,
    4,
    6,
    8,
    10,
    12,
    14,
    16
  ],
  "TotalItemNum": 8,
  "MoveVect": [
    0.0,
    0.0
  ],
  "TileLevelHardType": "Normal",
  "TotalCount": 90
}