{
  "AllLayerTileDict": {
    "1": {
      "68": 1,
      "102": 1,
      "72": 1,
      "136": 1,
      "132": 1,
      "162": 1,
      "196": 1,
      "166": 1,
      "200": 1,
      "170": 1,
      "140": 1,
      "106": 1,
      "76": 1,
      "98": 1,
      "38": 1,
      "42": 1
    },
    "2": {
      "99": 1,
      "101": 1,
      "103": 1,
      "105": 1,
      "107": 1,
      "67": 1,
      "69": 1,
      "71": 1,
      "73": 1,
      "75": 1,
      "131": 1,
      "133": 1,
      "135": 1,
      "137": 1,
      "139": 1,
      "163": 1,
      "165": 1,
      "167": 1,
      "169": 1,
      "171": 1
    },
    "3": {
      "41": 1,
      "37": 1,
      "76": 1,
      "106": 1,
      "136": 1,
      "166": 1,
      "201": 1,
      "72": 1,
      "102": 1,
      "132": 1,
      "162": 1,
      "98": 1,
      "140": 1,
      "197": 1,
      "170": 1,
      "68": 1
    },
    "4": {
      "163": 1,
      "165": 1,
      "71": 1,
      "73": 1,
      "75": 1,
      "131": 1,
      "133": 1,
      "103": 1,
      "105": 1,
      "107": 1,
      "99": 1,
      "101": 1,
      "135": 1,
      "137": 1,
      "139": 1,
      "67": 1,
      "69": 1,
      "167": 1,
      "169": 1,
      "171": 1,
      "38": 1,
      "42": 1,
      "196": 1,
      "200": 1
    },
    "5": {
      "98": 1,
      "68": 1,
      "39": 1,
      "199": 1,
      "170": 1,
      "140": 1,
      "195": 1,
      "166": 1,
      "136": 1,
      "106": 1,
      "76": 1,
      "43": 1,
      "72": 1,
      "102": 1,
      "132": 1,
      "162": 1
    },
    "6": {
      "181": 1,
      "155": 1,
      "185": 1,
      "83": 1,
      "53": 1,
      "151": 1,
      "121": 1,
      "87": 1,
      "117": 1,
      "147": 1
    }
  },
  "TileItemArray": [
    3,
    4,
    6,
    7,
    9,
    10,
    13,
    14
  ],
  "TotalItemNum": 8,
  "MoveVect": [
    0.0,
    0.0
  ],
  "TileTotalNum": 0,
  "TileLevelHardType": "Normal",
  "TotalCount": 102
}