{
  "AllLayerTileDict": {
    "1": {
      "34": 1,
      "36": 1,
      "38": 1,
      "200": 1,
      "202": 1,
      "204": 1,
      "82": 1,
      "146": 1,
      "84": 1,
      "148": 1,
      "86": 1,
      "150": 1,
      "88": 1,
      "152": 1,
      "90": 1,
      "154": 1,
      "92": 1,
      "156": 1
    },
    "2": {
      "50": 1,
      "52": 1,
      "54": 1,
      "184": 1,
      "186": 1,
      "188": 1,
      "130": 1,
      "132": 1,
      "134": 1,
      "136": 1,
      "138": 1,
      "140": 1,
      "98": 1,
      "100": 1,
      "102": 1,
      "104": 1,
      "106": 1,
      "108": 1
    },
    "3": {
      "39": 1,
      "71": 1,
      "167": 1,
      "199": 1,
      "114": 1,
      "116": 1,
      "118": 1,
      "120": 1,
      "122": 1,
      "124": 1,
      "51": 1,
      "53": 1,
      "185": 1,
      "187": 1
    },
    "4": {
      "50": 1,
      "52": 1,
      "54": 1,
      "56": 1,
      "182": 1,
      "184": 1,
      "186": 1,
      "188": 1,
      "98": 1,
      "100": 1,
      "102": 1,
      "104": 1,
      "106": 1,
      "108": 1,
      "130": 1,
      "132": 1,
      "134": 1,
      "136": 1,
      "138": 1,
      "140": 1
    },
    "5": {
      "115": 1,
      "117": 1,
      "119": 1,
      "121": 1,
      "123": 1
    }
  },
  "TileItemArray": [
    2,
    3,
    5,
    6,
    7,
    10,
    11,
    12,
    13,
    14
  ],
  "TotalItemNum": 10,
  "MoveVect": [
    0.0,
    0.0
  ],
  "TileLevelHardType": "Normal",
  "TotalCount": 75
}