{
  "AllLayerTileDict": {
    "1": {
      "128": 1,
      "130": 1,
      "136": 1,
      "134": 1,
      "132": 1,
      "138": 1,
      "140": 1,
      "142": 1,
      "196": 1,
      "198": 1,
      "200": 1,
      "202": 1
    },
    "2": {
      "112": 1,
      "114": 1,
      "116": 1,
      "118": 1,
      "120": 1,
      "122": 1,
      "124": 1,
      "126": 1,
      "179": 1,
      "181": 1,
      "183": 1,
      "185": 1,
      "187": 1
    },
    "3": {
      "98": 1,
      "100": 1,
      "102": 1,
      "104": 1,
      "106": 1,
      "108": 1,
      "110": 1,
      "96": 1,
      "163": 1,
      "165": 1,
      "167": 1,
      "169": 1,
      "171": 1
    },
    "4": {
      "80": 1,
      "82": 1,
      "84": 1,
      "86": 1,
      "88": 1,
      "90": 1,
      "92": 1,
      "94": 1,
      "146": 1,
      "148": 1,
      "150": 1,
      "152": 1,
      "154": 1,
      "156": 1
    },
    "5": {
      "64": 1,
      "66": 1,
      "68": 1,
      "70": 1,
      "72": 1,
      "74": 1,
      "76": 1,
      "78": 1,
      "130": 1,
      "132": 1,
      "134": 1,
      "136": 1,
      "138": 1,
      "140": 1
    },
    "6": {
      "48": 1,
      "50": 1,
      "52": 1,
      "54": 1,
      "56": 1,
      "58": 1,
      "60": 1,
      "62": 1,
      "114": 1,
      "116": 1,
      "118": 1,
      "120": 1,
      "122": 1,
      "124": 1,
      "231": 1
    }
  },
  "TileItemArray": [],
  "TotalItemNum": 10,
  "MoveVect": [
    0.0,
    -1.5
  ],
  "TileLevelHardType": "Normal",
  "TotalCount": 81
}