{
  "AllLayerTileDict": {
    "1": {
      "51": 1,
      "59": 1,
      "69": 1,
      "73": 1,
      "87": 1,
      "120": 1,
      "118": 1,
      "152": 1,
      "150": 1,
      "183": 1,
      "197": 1,
      "201": 1,
      "195": 1,
      "203": 1,
      "177": 1,
      "189": 1
    },
    "2": {
      "103": 1,
      "134": 1,
      "166": 1,
      "85": 1,
      "67": 1,
      "193": 1,
      "211": 1,
      "213": 1,
      "136": 1,
      "168": 1,
      "199": 1,
      "89": 1,
      "75": 1,
      "217": 1,
      "219": 1,
      "205": 1
    },
    "3": {
      "83": 1,
      "91": 1,
      "101": 1,
      "105": 1,
      "119": 1,
      "150": 1,
      "182": 1,
      "152": 1,
      "184": 1,
      "215": 1,
      "229": 1,
      "227": 1,
      "209": 1,
      "233": 1,
      "235": 1,
      "221": 1
    },
    "4": {
      "82": 1,
      "100": 1,
      "118": 1,
      "120": 1,
      "106": 1,
      "92": 1,
      "149": 1,
      "181": 1,
      "214": 1,
      "216": 1,
      "185": 1,
      "153": 1,
      "228": 1,
      "234": 1,
      "226": 1,
      "236": 1,
      "208": 1,
      "222": 1
    },
    "5": {
      "66": 1,
      "84": 1,
      "102": 1,
      "104": 1,
      "133": 1,
      "165": 1,
      "198": 1,
      "90": 1,
      "76": 1,
      "206": 1,
      "220": 1,
      "218": 1,
      "200": 1,
      "169": 1,
      "137": 1,
      "212": 1,
      "210": 1,
      "192": 1
    },
    "6": {
      "50": 1,
      "60": 1,
      "68": 1,
      "74": 1,
      "86": 1,
      "88": 1,
      "117": 1,
      "121": 1,
      "149": 1,
      "153": 1,
      "182": 1,
      "184": 1,
      "196": 1,
      "202": 1,
      "194": 1,
      "204": 1,
      "176": 1,
      "190": 1
    }
  },
  "TileItemArray": [],
  "TotalItemNum": 10,
  "MoveVect": [
    0.0,
    -1.5
  ],
  "TileTotalNum": 0,
  "TileLevelHardType": "Normal",
  "TotalCount": 102
}