{
  "AllLayerTileDict": {
    "1": {
      "17": "1",
      "29": "1",
      "209": "1",
      "221": "1",
      "81": "1",
      "93": "1",
      "145": "1",
      "157": "1",
      "37": "1",
      "41": "1",
      "197": "1",
      "201": "1"
    },
    "2": {
      "34": "1",
      "194": "1",
      "44": "1",
      "204": "1",
      "57": "1",
      "185": "1",
      "53": "1",
      "181": "1",
      "82": "1",
      "92": "1",
      "146": "1",
      "156": "1"
    },
    "3": {
      "59": "1",
      "187": "1",
      "83": "1",
      "147": "1",
      "91": "1",
      "155": "1",
      "73": "1",
      "169": "1",
      "69": "1",
      "165": "1",
      "51": "1",
      "179": "1"
    },
    "4": {
      "68": "1",
      "164": "1",
      "74": "1",
      "170": "1",
      "100": "1",
      "132": "1",
      "106": "1",
      "138": "1",
      "86": "1",
      "150": "1",
      "88": "1",
      "152": "1",
      "98": "1",
      "108": "1",
      "130": "1",
      "140": "1",
      "66": "1",
      "76": "1",
      "162": "1",
      "172": "1"
    },
    "5": {
      "103": "1",
      "135": "1",
      "105": "1",
      "137": "1",
      "101": "1",
      "133": "1",
      "115": "1",
      "123": "1",
      "83": "1",
      "91": "1",
      "147": "1",
      "155": "1",
      "167": "1",
      "71": "1",
      "165": "1",
      "69": "1",
      "113": "1",
      "125": "1",
      "49": "1",
      "177": "1",
      "61": "1",
      "189": "1",
      "169": "1",
      "73": "1"
    },
    "6": {
      "33": "1",
      "193": "1",
      "45": "1",
      "205": "1",
      "98": "1",
      "130": "1",
      "100": "1",
      "132": "1",
      "102": "1",
      "134": "1",
      "104": "1",
      "136": "1",
      "106": "1",
      "138": "1",
      "108": "1",
      "140": "1",
      "162": "1",
      "164": "1",
      "166": "1",
      "168": "1",
      "170": "1",
      "172": "1",
      "66": "1",
      "68": "1",
      "70": "1",
      "72": "1",
      "74": "1",
      "76": "1"
    }
  },
  "TileItemArray": [],
  "TotalItemNum": 13,
  "MoveVect": [
    0.0,
    0.0
  ],
  "TileTotalNum": 0,
  "TileLevelHardType": "Normal",
  "TotalCount": 108
}