{
  "AllLayerTileDict": {
    "1": {
      "34": 1,
      "194": 1,
      "44": 1,
      "204": 1,
      "68": 1,
      "164": 1,
      "74": 1,
      "170": 1,
      "129": 1,
      "97": 1,
      "131": 1,
      "99": 1,
      "133": 1,
      "101": 1,
      "135": 1,
      "103": 1,
      "137": 1,
      "105": 1,
      "139": 1,
      "107": 1,
      "141": 1,
      "109": 1
    },
    "2": {
      "51": 1,
      "179": 1,
      "59": 1,
      "187": 1,
      "114": 1,
      "116": 1,
      "118": 1,
      "120": 1,
      "122": 1,
      "124": 1
    },
    "3": {
      "36": 1,
      "196": 1,
      "66": 1,
      "162": 1,
      "76": 1,
      "172": 1,
      "42": 1,
      "202": 1,
      "99": 1,
      "101": 1,
      "103": 1,
      "105": 1,
      "107": 1,
      "131": 1,
      "133": 1,
      "135": 1,
      "137": 1,
      "139": 1
    },
    "4": {
      "51": 1,
      "179": 1,
      "59": 1,
      "187": 1,
      "114": 1,
      "116": 1,
      "118": 1,
      "120": 1,
      "122": 1,
      "124": 1
    },
    "5": {
      "36": 1,
      "196": 1,
      "42": 1,
      "202": 1,
      "66": 1,
      "162": 1,
      "76": 1,
      "172": 1,
      "68": 1,
      "164": 1,
      "74": 1,
      "170": 1,
      "34": 1,
      "194": 1,
      "44": 1,
      "204": 1,
      "115": 1,
      "117": 1,
      "119": 1,
      "121": 1,
      "123": 1
    }
  },
  "TileItemArray": [
    2,
    4,
    6,
    7,
    8,
    9,
    10,
    14,
    15,
    13
  ],
  "TotalItemNum": 10,
  "MoveVect": [
    0.0,
    0.0
  ],
  "TileTotalNum": 0,
  "TileLevelHardType": "Normal",
  "TotalCount": 81
}