{
  "AllLayerTileDict": {
    "1": {
      "92": "1",
      "156": "1",
      "62": "1",
      "190": "1",
      "126": "1",
      "122": "1",
      "124": "1"
    },
    "2": {
      "123": "1",
      "61": "1",
      "189": "1",
      "91": "1",
      "155": "1",
      "125": "1",
      "121": "1"
    },
    "3": {
      "122": "1",
      "30": "1",
      "222": "1",
      "124": "1",
      "60": "1",
      "188": "1",
      "120": "1",
      "90": "1",
      "154": "1",
      "126": "1"
    },
    "4": {
      "121": "1",
      "119": "1",
      "59": "1",
      "187": "1",
      "29": "1",
      "221": "1",
      "125": "1",
      "89": "1",
      "153": "1",
      "123": "1"
    },
    "5": {
      "126": "1",
      "58": "1",
      "186": "1",
      "28": "1",
      "220": "1",
      "124": "1",
      "122": "1",
      "88": "1",
      "152": "1",
      "120": "1",
      "118": "1"
    },
    "6": {
      "27": "1",
      "219": "1",
      "57": "1",
      "185": "1",
      "121": "1",
      "125": "1",
      "87": "1",
      "151": "1",
      "123": "1",
      "119": "1",
      "117": "1"
    },
    "7": {
      "116": "1",
      "118": "1",
      "120": "1",
      "122": "1",
      "124": "1",
      "126": "1",
      "86": "1",
      "150": "1",
      "56": "1",
      "184": "1",
      "26": "1",
      "218": "1"
    },
    "8": {
      "115": "1",
      "117": "1",
      "119": "1",
      "121": "1",
      "123": "1",
      "125": "1",
      "85": "1",
      "149": "1",
      "55": "1",
      "183": "1",
      "25": "1",
      "217": "1"
    },
    "9": {
      "114": "1",
      "116": "1",
      "118": "1",
      "120": "1",
      "122": "1",
      "124": "1",
      "126": "1",
      "84": "1",
      "148": "1",
      "54": "1",
      "182": "1",
      "24": "1",
      "216": "1"
    }
  },
  "TileItemArray": [],
  "TotalItemNum": 11,
  "MoveVect": [
    -1.0,
    0.0
  ],
  "TileTotalNum": 0,
  "TileLevelHardType": "Normal",
  "TotalCount": 93
}