{
  "AllLayerTileDict": {
    "1": {
      "37": 1,
      "197": 1,
      "35": 1,
      "195": 1,
      "140": 1,
      "108": 1,
      "68": 1,
      "164": 1,
      "70": 1,
      "166": 1,
      "72": 1,
      "168": 1,
      "102": 1,
      "134": 1,
      "104": 1,
      "136": 1,
      "106": 1,
      "138": 1
    },
    "2": {
      "50": 1,
      "178": 1,
      "52": 1,
      "180": 1,
      "54": 1,
      "182": 1,
      "56": 1,
      "184": 1,
      "85": 1,
      "149": 1,
      "87": 1,
      "151": 1,
      "89": 1,
      "153": 1,
      "119": 1,
      "121": 1,
      "123": 1
    },
    "3": {
      "67": 1,
      "163": 1,
      "69": 1,
      "165": 1,
      "71": 1,
      "167": 1,
      "73": 1,
      "169": 1,
      "102": 1,
      "134": 1,
      "104": 1,
      "136": 1,
      "106": 1,
      "138": 1,
      "124": 1
    },
    "4": {
      "84": 1,
      "148": 1,
      "86": 1,
      "150": 1,
      "88": 1,
      "152": 1,
      "90": 1,
      "154": 1,
      "119": 1,
      "121": 1,
      "123": 1
    },
    "5": {
      "68": 1,
      "74": 1,
      "72": 1,
      "70": 1,
      "164": 1,
      "166": 1,
      "168": 1,
      "170": 1,
      "136": 1,
      "104": 1,
      "138": 1,
      "106": 1,
      "140": 1,
      "108": 1
    },
    "6": {
      "52": 1,
      "180": 1,
      "54": 1,
      "182": 1,
      "58": 1,
      "186": 1,
      "56": 1,
      "184": 1,
      "88": 1,
      "152": 1,
      "90": 1,
      "154": 1,
      "92": 1,
      "156": 1
    },
    "7": {
      "36": 1,
      "196": 1,
      "38": 1,
      "198": 1,
      "40": 1,
      "200": 1,
      "42": 1,
      "202": 1,
      "72": 1,
      "168": 1,
      "74": 1,
      "170": 1,
      "76": 1,
      "172": 1,
      "108": 1,
      "140": 1
    }
  },
  "TileItemArray": [],
  "TotalItemNum": 8,
  "MoveVect": [
    0.0,
    0.0
  ],
  "TileLevelHardType": "Hard",
  "TotalCount": 105
}