{
  "AllLayerTileDict": {
    "1": {
      "65": 1,
      "173": 1,
      "18": 1,
      "220": 1
    },
    "2": {
      "19": 1,
      "219": 1,
      "50": 1,
      "188": 1,
      "81": 1,
      "157": 1
    },
    "3": {
      "36": 1,
      "202": 1,
      "67": 1,
      "171": 1,
      "97": 1,
      "141": 1,
      "115": 1,
      "123": 1,
      "54": 1,
      "184": 1
    },
    "4": {
      "70": 1,
      "168": 1,
      "52": 1,
      "186": 1,
      "83": 1,
      "124": 1,
      "114": 1,
      "137": 1,
      "132": 1,
      "155": 1,
      "101": 1,
      "106": 1
    },
    "5": {
      "53": 1,
      "57": 1,
      "181": 1,
      "185": 1,
      "85": 1,
      "89": 1,
      "117": 1,
      "121": 1,
      "149": 1,
      "153": 1,
      "99": 1,
      "107": 1,
      "131": 1,
      "139": 1,
      "67": 1,
      "75": 1,
      "163": 1,
      "171": 1
    },
    "6": {
      "68": 1,
      "74": 1,
      "100": 1,
      "106": 1,
      "132": 1,
      "138": 1,
      "164": 1,
      "170": 1,
      "38": 1,
      "40": 1,
      "70": 1,
      "72": 1,
      "102": 1,
      "104": 1,
      "134": 1,
      "136": 1,
      "166": 1,
      "168": 1,
      "198": 1,
      "200": 1
    },
    "7": {
      "55": 1,
      "119": 1,
      "183": 1,
      "85": 1,
      "149": 1,
      "89": 1,
      "153": 1,
      "51": 1,
      "81": 1,
      "145": 1,
      "115": 1,
      "179": 1,
      "59": 1,
      "187": 1,
      "93": 1,
      "157": 1,
      "123": 1
    }
  },
  "TileItemArray": [],
  "TotalItemNum": 9,
  "MoveVect": [
    0.0,
    0.0
  ],
  "TileLevelHardType": "Normal",
  "TotalCount": 87
}