{
  "AllLayerTileDict": {
    "1": {
      "81": 1,
      "93": 1,
      "145": 1,
      "157": 1,
      "116": 1,
      "122": 1,
      "102": 1,
      "104": 1,
      "134": 1,
      "136": 1,
      "50": 1,
      "60": 1,
      "178": 1,
      "188": 1,
      "36": 1,
      "42": 1,
      "196": 1,
      "202": 1,
      "18": 1,
      "28": 1,
      "210": 1,
      "220": 1,
      "114": 1,
      "124": 1,
      "69": 1,
      "73": 1,
      "165": 1,
      "169": 1
    },
    "2": {
      "65": 1,
      "77": 1,
      "161": 1,
      "173": 1,
      "97": 1,
      "109": 1,
      "129": 1,
      "141": 1,
      "115": 1,
      "123": 1,
      "51": 1,
      "59": 1,
      "179": 1,
      "187": 1,
      "53": 1,
      "57": 1,
      "181": 1,
      "185": 1,
      "85": 1,
      "89": 1,
      "117": 1,
      "121": 1,
      "149": 1,
      "153": 1,
      "87": 1,
      "151": 1
    },
    "3": {
      "36": 1,
      "42": 1,
      "196": 1,
      "202": 1,
      "66": 1,
      "76": 1,
      "162": 1,
      "172": 1,
      "100": 1,
      "106": 1,
      "132": 1,
      "138": 1,
      "114": 1,
      "124": 1,
      "71": 1,
      "167": 1
    },
    "4": {
      "19": 1,
      "211": 1,
      "55": 1,
      "27": 1,
      "219": 1,
      "83": 1,
      "91": 1,
      "113": 1,
      "125": 1,
      "147": 1,
      "155": 1,
      "183": 1,
      "117": 1,
      "121": 1
    },
    "5": {
      "36": 1,
      "196": 1,
      "38": 1,
      "198": 1,
      "40": 1,
      "200": 1,
      "42": 1,
      "202": 1,
      "116": 1,
      "122": 1,
      "84": 1,
      "90": 1,
      "148": 1,
      "154": 1,
      "118": 1,
      "120": 1,
      "71": 1,
      "167": 1,
      "98": 1,
      "130": 1,
      "108": 1,
      "140": 1
    },
    "6": {
      "55": 1,
      "87": 1,
      "165": 1,
      "169": 1,
      "69": 1,
      "151": 1,
      "119": 1,
      "101": 1,
      "133": 1,
      "105": 1,
      "137": 1,
      "99": 1,
      "131": 1,
      "107": 1,
      "139": 1,
      "73": 1,
      "183": 1,
      "17": 1,
      "29": 1,
      "209": 1,
      "221": 1,
      "49": 1,
      "61": 1,
      "177": 1,
      "189": 1,
      "51": 1,
      "59": 1,
      "179": 1,
      "187": 1,
      "19": 1,
      "27": 1,
      "211": 1,
      "219": 1,
      "113": 1,
      "125": 1
    }
  },
  "TileItemArray": [],
  "TotalItemNum": 13,
  "MoveVect": [
    0.0,
    0.0
  ],
  "TileLevelHardType": "Normal",
  "TotalCount": 141
}