{
  "AllLayerTileDict": {
    "1": {
      "34": 1,
      "44": 1,
      "36": 1,
      "42": 1,
      "162": 1,
      "172": 1,
      "164": 1,
      "170": 1,
      "100": 1,
      "102": 1,
      "104": 1,
      "106": 1
    },
    "2": {
      "35": 1,
      "43": 1,
      "163": 1,
      "171": 1,
      "37": 1,
      "41": 1,
      "165": 1,
      "169": 1,
      "116": 1,
      "118": 1,
      "120": 1,
      "122": 1,
      "84": 1,
      "86": 1,
      "88": 1,
      "90": 1
    },
    "3": {
      "52": 1,
      "58": 1,
      "54": 1,
      "56": 1,
      "148": 1,
      "154": 1,
      "150": 1,
      "152": 1,
      "99": 1,
      "101": 1,
      "103": 1,
      "105": 1,
      "107": 1,
      "180": 1,
      "182": 1,
      "184": 1,
      "186": 1
    },
    "4": {
      "67": 1,
      "69": 1,
      "71": 1,
      "73": 1,
      "75": 1,
      "115": 1,
      "117": 1,
      "119": 1,
      "121": 1,
      "123": 1,
      "163": 1,
      "165": 1,
      "167": 1,
      "169": 1,
      "171": 1
    },
    "5": {
      "178": 1,
      "180": 1,
      "182": 1,
      "184": 1,
      "186": 1,
      "188": 1,
      "130": 1,
      "132": 1,
      "134": 1,
      "136": 1,
      "138": 1,
      "140": 1,
      "50": 1,
      "52": 1,
      "54": 1,
      "56": 1,
      "58": 1,
      "60": 1
    }
  },
  "TileItemArray": [
    2,
    3,
    5,
    6,
    8,
    9,
    11,
    12,
    14,
    15
  ],
  "TotalItemNum": 10,
  "MoveVect": [
    0.0,
    0.5
  ],
  "TileLevelHardType": "Normal",
  "TotalCount": 78
}