{
  "AllLayerTileDict": {
    "1": {
      "98": 1,
      "68": 1,
      "70": 1,
      "132": 1,
      "134": 1,
      "73": 1,
      "75": 1,
      "137": 1,
      "139": 1,
      "146": 1,
      "50": 1
    },
    "2": {
      "66": 1,
      "162": 1,
      "84": 1,
      "156": 1,
      "86": 1,
      "88": 1,
      "90": 1,
      "92": 1,
      "148": 1,
      "150": 1,
      "152": 1,
      "154": 1,
      "114": 1
    },
    "3": {
      "172": 1,
      "130": 1,
      "178": 1,
      "164": 1,
      "166": 1,
      "168": 1,
      "170": 1,
      "108": 1,
      "106": 1,
      "102": 1,
      "104": 1,
      "100": 1,
      "82": 1
    },
    "4": {
      "119": 1,
      "98": 1,
      "149": 1,
      "117": 1,
      "131": 1,
      "162": 1,
      "155": 1,
      "153": 1,
      "123": 1,
      "121": 1,
      "151": 1
    },
    "5": {
      "114": 1,
      "100": 1,
      "102": 1,
      "104": 1,
      "178": 1,
      "164": 1,
      "166": 1,
      "168": 1,
      "170": 1,
      "138": 1,
      "136": 1,
      "134": 1,
      "132": 1,
      "172": 1,
      "106": 1,
      "140": 1,
      "108": 1
    },
    "6": {
      "130": 1,
      "162": 1,
      "116": 1,
      "118": 1,
      "120": 1,
      "122": 1,
      "124": 1,
      "148": 1,
      "150": 1,
      "152": 1,
      "154": 1,
      "156": 1
    },
    "7": {
      "146": 1,
      "132": 1,
      "134": 1,
      "136": 1,
      "138": 1,
      "140": 1
    },
    "8": {
      "130": 1,
      "148": 1,
      "150": 1,
      "156": 1,
      "154": 1,
      "152": 1,
      "162": 1
    }
  },
  "TileItemArray": [
    2,
    3,
    5,
    6,
    8,
    9,
    11,
    12,
    14,
    15,
    16
  ],
  "TotalItemNum": 11,
  "MoveVect": [
    0.0,
    0.0
  ],
  "TileTotalNum": 0,
  "TileLevelHardType": "Normal",
  "TotalCount": 90
}