{
  "AllLayerTileDict": {
    "1": {
      "66": 1,
      "98": 1,
      "130": 1,
      "162": 1,
      "164": 1,
      "166": 1,
      "168": 1,
      "170": 1,
      "70": 1,
      "102": 1,
      "134": 1,
      "172": 1,
      "74": 1,
      "106": 1,
      "138": 1
    },
    "2": {
      "53": 1,
      "51": 1,
      "49": 1,
      "55": 1,
      "57": 1,
      "59": 1,
      "61": 1,
      "113": 1,
      "115": 1,
      "117": 1,
      "119": 1,
      "121": 1,
      "123": 1,
      "177": 1,
      "179": 1,
      "181": 1,
      "183": 1,
      "185": 1,
      "187": 1,
      "189": 1
    },
    "3": {
      "66": 1,
      "70": 1,
      "74": 1,
      "130": 1,
      "134": 1,
      "138": 1,
      "194": 1,
      "198": 1,
      "202": 1,
      "76": 1,
      "204": 1
    },
    "4": {
      "50": 1,
      "54": 1,
      "58": 1,
      "60": 1,
      "178": 1,
      "182": 1,
      "186": 1,
      "188": 1,
      "114": 1,
      "118": 1,
      "122": 1
    },
    "5": {
      "66": 1,
      "34": 1,
      "70": 1,
      "38": 1,
      "74": 1,
      "42": 1,
      "44": 1,
      "76": 1,
      "194": 1,
      "162": 1,
      "113": 1,
      "115": 1,
      "117": 1,
      "119": 1,
      "121": 1,
      "123": 1,
      "166": 1,
      "198": 1,
      "170": 1,
      "172": 1,
      "202": 1,
      "204": 1
    },
    "6": {
      "51": 1,
      "53": 1,
      "55": 1,
      "57": 1,
      "59": 1,
      "61": 1,
      "183": 1,
      "181": 1,
      "179": 1,
      "185": 1,
      "187": 1,
      "189": 1,
      "98": 1,
      "130": 1,
      "100": 1,
      "132": 1,
      "102": 1,
      "104": 1,
      "106": 1,
      "134": 1,
      "136": 1,
      "138": 1
    },
    "7": {
      "34": 1,
      "194": 1,
      "115": 1,
      "119": 1,
      "123": 1,
      "198": 1,
      "38": 1
    }
  },
  "TileItemArray": [],
  "TotalItemNum": 12,
  "MoveVect": [
    0.0,
    0.0
  ],
  "TileTotalNum": 0,
  "TileLevelHardType": "Normal",
  "TotalCount": 108
}