{
  "AllLayerTileDict": {
    "1": {
      "23": 1,
      "215": 1,
      "53": 1,
      "181": 1,
      "57": 1,
      "185": 1,
      "83": 1,
      "147": 1,
      "91": 1,
      "155": 1,
      "113": 1,
      "125": 1,
      "71": 1,
      "102": 1,
      "133": 1,
      "104": 1,
      "137": 1,
      "167": 1
    },
    "2": {
      "38": 1,
      "198": 1,
      "40": 1,
      "200": 1,
      "68": 1,
      "164": 1,
      "74": 1,
      "170": 1,
      "98": 1,
      "130": 1,
      "108": 1,
      "140": 1,
      "87": 1,
      "118": 1,
      "120": 1,
      "151": 1
    },
    "3": {
      "39": 1,
      "103": 1,
      "135": 1,
      "199": 1,
      "53": 1,
      "57": 1,
      "83": 1,
      "91": 1,
      "147": 1,
      "155": 1,
      "181": 1,
      "185": 1,
      "115": 1,
      "123": 1
    },
    "4": {
      "54": 1,
      "56": 1,
      "119": 1,
      "99": 1,
      "131": 1,
      "107": 1,
      "139": 1,
      "182": 1,
      "184": 1
    },
    "5": {
      "55": 1,
      "183": 1,
      "115": 1,
      "123": 1,
      "135": 1,
      "103": 1
    },
    "6": {
      "71": 1,
      "119": 1,
      "167": 1,
      "116": 1,
      "122": 1
    },
    "7": {
      "87": 1,
      "135": 1,
      "117": 1,
      "121": 1
    }
  },
  "TileItemArray": [],
  "TotalItemNum": 10,
  "MoveVect": [
    0.0,
    0.0
  ],
  "TileTotalNum": 0,
  "TileLevelHardType": "Normal",
  "TotalCount": 72
}