{
  "AllLayerTileDict": {
    "1": {
      "35": 1,
      "195": 1,
      "43": 1,
      "203": 1,
      "68": 1,
      "164": 1,
      "74": 1,
      "170": 1,
      "82": 1,
      "146": 1,
      "92": 1,
      "156": 1,
      "100": 1,
      "132": 1,
      "106": 1,
      "138": 1,
      "86": 1,
      "150": 1,
      "88": 1,
      "152": 1,
      "55": 1,
      "183": 1,
      "119": 1
    },
    "2": {
      "53": 1,
      "181": 1,
      "71": 1,
      "167": 1,
      "57": 1,
      "185": 1,
      "101": 1,
      "105": 1,
      "133": 1,
      "137": 1,
      "83": 1,
      "147": 1,
      "91": 1,
      "155": 1,
      "51": 1,
      "179": 1,
      "59": 1,
      "187": 1,
      "135": 1,
      "103": 1
    },
    "3": {
      "68": 1,
      "164": 1,
      "74": 1,
      "170": 1,
      "116": 1,
      "118": 1,
      "120": 1,
      "122": 1,
      "86": 1,
      "88": 1,
      "150": 1,
      "152": 1,
      "54": 1,
      "182": 1,
      "56": 1,
      "184": 1
    },
    "4": {
      "51": 1,
      "179": 1,
      "59": 1,
      "187": 1,
      "85": 1,
      "89": 1,
      "149": 1,
      "153": 1,
      "117": 1,
      "119": 1,
      "121": 1,
      "167": 1,
      "71": 1,
      "115": 1,
      "123": 1,
      "197": 1,
      "37": 1,
      "201": 1,
      "41": 1
    },
    "5": {
      "52": 1,
      "180": 1,
      "58": 1,
      "186": 1,
      "102": 1,
      "104": 1,
      "134": 1,
      "136": 1,
      "166": 1,
      "70": 1,
      "168": 1,
      "72": 1,
      "116": 1,
      "122": 1
    },
    "6": {
      "86": 1,
      "150": 1,
      "88": 1,
      "152": 1,
      "117": 1,
      "121": 1,
      "119": 1
    }
  },
  "TileItemArray": [],
  "TotalItemNum": 10,
  "MoveVect": [
    0.0,
    0.0
  ],
  "TileTotalNum": 0,
  "TileLevelHardType": "Normal",
  "TotalCount": 99
}