{
  "AllLayerTileDict": {
    "1": {
      "54": "1",
      "56": "1",
      "36": "1",
      "42": "1",
      "34": "1",
      "44": "1",
      "65": "1",
      "77": "1",
      "98": "1",
      "108": "1",
      "215": "1",
      "197": "1",
      "201": "1",
      "164": "1",
      "170": "1",
      "131": "1",
      "139": "1",
      "86": "1",
      "88": "1"
    },
    "2": {
      "181": "1",
      "185": "1",
      "148": "1",
      "154": "1",
      "199": "1",
      "115": "1",
      "123": "1",
      "82": "1",
      "92": "1",
      "51": "-1",
      "59": "0",
      "71": "-3",
      "49": "1",
      "61": "1",
      "19": "1",
      "27": "1",
      "37": "1",
      "41": "1"
    },
    "3": {
      "36": "1",
      "42": "1",
      "56": "1",
      "34": "1",
      "44": "1",
      "68": "1",
      "74": "1",
      "88": "1",
      "66": "1",
      "76": "1",
      "54": "1",
      "86": "1",
      "99": "1",
      "107": "1",
      "132": "1",
      "138": "1",
      "165": "1",
      "169": "1",
      "183": "1"
    },
    "4": {
      "164": "1",
      "100": "1",
      "133": "1",
      "137": "1",
      "71": "-3",
      "170": "1",
      "59": "0",
      "166": "1",
      "106": "1",
      "51": "-1",
      "168": "1",
      "198": "1",
      "200": "1",
      "131": "1",
      "139": "1"
    },
    "5": {
      "183": "1",
      "185": "1",
      "181": "1",
      "140": "1",
      "150": "1",
      "130": "1",
      "152": "1",
      "154": "1",
      "148": "1",
      "116": "1",
      "122": "1",
      "179": "1",
      "187": "1",
      "213": "1",
      "215": "1",
      "217": "1",
      "51": "-1",
      "59": "0",
      "71": "-3"
    },
    "6": {
      "114": "1",
      "124": "1",
      "146": "1",
      "156": "1",
      "178": "1",
      "188": "1",
      "100": "1",
      "106": "1",
      "132": "1",
      "138": "1",
      "164": "1",
      "170": "1",
      "196": "1",
      "202": "1",
      "198": "1",
      "166": "1",
      "134": "1",
      "136": "1",
      "168": "1",
      "200": "1",
      "51": "-1",
      "59": "0",
      "71": "-3"
    },
    "7": {
      "97": "1",
      "109": "1",
      "129": "1",
      "141": "1",
      "161": "1",
      "173": "1",
      "193": "1",
      "205": "1",
      "195": "1",
      "203": "1",
      "163": "1",
      "171": "1",
      "131": "1",
      "139": "1",
      "99": "1",
      "107": "1",
      "101": "1",
      "105": "1",
      "133": "1",
      "137": "1",
      "165": "1",
      "169": "1",
      "197": "1",
      "201": "1",
      "51": "-1",
      "59": "0",
      "71": "-3"
    },
    "8": {
      "71": "-3"
    }
  },
  "TileItemArray": [],
  "TotalItemNum": 13,
  "MoveVect": [
    0.0,
    0.0
  ],
  "TileTotalNum": 0,
  "TileLevelHardType": "Normal",
  "TotalCount": 141
}