{
  "AllLayerTileDict": {
    "1": {
      "35": 1,
      "37": 1,
      "39": 1,
      "41": 1,
      "43": 1,
      "177": 1,
      "179": 1,
      "181": 1,
      "183": 1,
      "185": 1,
      "187": 1,
      "189": 1,
      "145": 1,
      "147": 1,
      "149": 1,
      "151": 1,
      "153": 1,
      "155": 1,
      "157": 1
    },
    "2": {
      "50": 1,
      "52": 1,
      "54": 1,
      "56": 1,
      "58": 1,
      "60": 1,
      "130": 1,
      "132": 1,
      "134": 1,
      "136": 1,
      "138": 1,
      "140": 1,
      "162": 1,
      "164": 1,
      "166": 1,
      "168": 1,
      "170": 1,
      "172": 1
    },
    "3": {
      "67": 1,
      "69": 1,
      "71": 1,
      "73": 1,
      "75": 1,
      "115": 1,
      "117": 1,
      "119": 1,
      "121": 1,
      "123": 1,
      "147": 1,
      "149": 1,
      "151": 1,
      "153": 1,
      "155": 1
    },
    "4": {
      "68": 1,
      "70": 1,
      "72": 1,
      "74": 1,
      "116": 1,
      "118": 1,
      "120": 1,
      "122": 1,
      "148": 1,
      "150": 1,
      "152": 1,
      "154": 1
    },
    "5": {
      "51": 1,
      "53": 1,
      "55": 1,
      "57": 1,
      "59": 1,
      "163": 1,
      "165": 1,
      "167": 1,
      "169": 1,
      "171": 1,
      "99": 1,
      "101": 1,
      "103": 1,
      "105": 1,
      "107": 1
    },
    "6": {
      "34": 1,
      "36": 1,
      "38": 1,
      "40": 1,
      "42": 1,
      "44": 1,
      "82": 1,
      "84": 1,
      "86": 1,
      "88": 1,
      "90": 1,
      "92": 1,
      "146": 1,
      "148": 1,
      "150": 1,
      "152": 1,
      "154": 1,
      "156": 1,
      "178": 1,
      "188": 1
    }
  },
  "TileItemArray": [],
  "TotalItemNum": 11,
  "MoveVect": [
    0.0,
    0.5
  ],
  "TileTotalNum": 0,
  "TileLevelHardType": "Normal",
  "TotalCount": 99
}