{
  "AllLayerTileDict": {
    "1": {
      "20": 1,
      "22": 1,
      "24": 1,
      "26": 1,
      "28": 1,
      "18": 1,
      "51": 1,
      "53": 1,
      "55": 1,
      "57": 1,
      "59": 1,
      "84": 1,
      "86": 1,
      "88": 1,
      "90": 1,
      "117": 1,
      "119": 1,
      "121": 1,
      "150": 1,
      "152": 1,
      "183": 1
    },
    "2": {
      "34": 1,
      "36": 1,
      "38": 1,
      "40": 1,
      "42": 1,
      "44": 1,
      "67": 1,
      "69": 1,
      "71": 1,
      "73": 1,
      "75": 1,
      "100": 1,
      "102": 1,
      "104": 1,
      "106": 1,
      "133": 1,
      "135": 1,
      "137": 1,
      "166": 1,
      "168": 1,
      "199": 1
    },
    "3": {
      "50": 1,
      "52": 1,
      "54": 1,
      "56": 1,
      "58": 1,
      "60": 1,
      "83": 1,
      "85": 1,
      "87": 1,
      "89": 1,
      "91": 1,
      "116": 1,
      "118": 1,
      "120": 1,
      "122": 1,
      "149": 1,
      "151": 1,
      "153": 1,
      "182": 1,
      "184": 1
    },
    "4": {
      "66": 1,
      "68": 1,
      "70": 1,
      "72": 1,
      "74": 1,
      "76": 1,
      "99": 1,
      "101": 1,
      "103": 1,
      "105": 1,
      "107": 1,
      "132": 1,
      "134": 1,
      "136": 1,
      "138": 1,
      "165": 1,
      "167": 1,
      "169": 1,
      "199": 1
    },
    "5": {
      "82": 1,
      "84": 1,
      "86": 1,
      "88": 1,
      "90": 1,
      "92": 1,
      "115": 1,
      "117": 1,
      "119": 1,
      "121": 1,
      "123": 1,
      "148": 1,
      "150": 1,
      "152": 1,
      "154": 1,
      "181": 1,
      "183": 1,
      "185": 1
    },
    "6": {
      "98": 1,
      "100": 1,
      "102": 1,
      "104": 1,
      "106": 1,
      "108": 1,
      "131": 1,
      "133": 1,
      "135": 1,
      "137": 1,
      "139": 1,
      "164": 1,
      "166": 1,
      "168": 1,
      "170": 1
    },
    "7": {
      "115": 1,
      "117": 1,
      "119": 1,
      "121": 1,
      "123": 1,
      "148": 1,
      "150": 1,
      "152": 1,
      "154": 1
    }
  },
  "TileItemArray": [],
  "TotalItemNum": 15,
  "MoveVect": [
    0.0,
    0.5
  ],
  "TileTotalNum": 0,
  "TileLevelHardType": "Normal",
  "TotalCount": 123
}