{
  "AllLayerTileDict": {
    "1": {
      "51": 1,
      "179": 1,
      "53": 1,
      "181": 1,
      "55": 1,
      "183": 1,
      "57": 1,
      "185": 1,
      "59": 1,
      "187": 1,
      "83": 1,
      "147": 1,
      "85": 1,
      "149": 1,
      "87": 1,
      "151": 1,
      "89": 1,
      "153": 1,
      "91": 1,
      "155": 1,
      "115": 1,
      "117": 1,
      "119": 1,
      "121": 1,
      "123": 1
    },
    "2": {
      "43": 1,
      "203": 1,
      "39": 1,
      "199": 1,
      "37": 1,
      "197": 1,
      "35": 1,
      "195": 1,
      "41": 1,
      "201": 1,
      "66": 1,
      "76": 1,
      "98": 1,
      "108": 1,
      "162": 1,
      "172": 1,
      "130": 1,
      "140": 1,
      "68": 1,
      "70": 1,
      "72": 1,
      "74": 1,
      "100": 1,
      "102": 1,
      "104": 1,
      "106": 1,
      "132": 1,
      "134": 1,
      "136": 1,
      "138": 1,
      "164": 1,
      "166": 1,
      "168": 1,
      "170": 1
    },
    "3": {
      "51": 1,
      "179": 1,
      "53": 1,
      "181": 1,
      "55": 1,
      "183": 1,
      "57": 1,
      "185": 1,
      "59": 1,
      "187": 1,
      "83": 1,
      "147": 1,
      "85": 1,
      "149": 1,
      "87": 1,
      "151": 1,
      "89": 1,
      "153": 1,
      "91": 1,
      "155": 1,
      "115": 1,
      "117": 1,
      "119": 1,
      "121": 1,
      "123": 1
    },
    "4": {
      "68": 1,
      "164": 1,
      "70": 1,
      "166": 1,
      "72": 1,
      "168": 1,
      "74": 1,
      "170": 1,
      "100": 1,
      "132": 1,
      "102": 1,
      "134": 1,
      "104": 1,
      "136": 1,
      "106": 1,
      "138": 1
    },
    "5": {
      "85": 1,
      "87": 1,
      "89": 1,
      "121": 1,
      "119": 1,
      "117": 1,
      "149": 1,
      "151": 1,
      "153": 1
    },
    "6": {
      "102": 1,
      "136": 1,
      "104": 1,
      "134": 1
    },
    "7": {
      "119": 1
    }
  },
  "TileItemArray": [],
  "TotalItemNum": 10,
  "MoveVect": [
    0.0,
    0.0
  ],
  "TileTotalNum": 0,
  "TileLevelHardType": "Hard",
  "TotalCount": 114
}