{
  "AllLayerTileDict": {
    "1": {
      "147": "1",
      "155": "1",
      "177": "1",
      "189": "1",
      "23": "1",
      "85": "1",
      "89": "1",
      "116": "1",
      "122": "1",
      "45": "-1",
      "33": "0"
    },
    "2": {
      "100": "1",
      "39": "1",
      "172": "1",
      "162": "1",
      "106": "1",
      "45": "-1",
      "33": "0"
    },
    "3": {
      "121": "1",
      "55": "1",
      "117": "1",
      "179": "1",
      "187": "1",
      "45": "-1",
      "33": "0"
    },
    "4": {
      "195": "1",
      "137": "1",
      "164": "1",
      "203": "1",
      "201": "1",
      "69": "1",
      "71": "1",
      "73": "1",
      "133": "1",
      "45": "-1",
      "33": "0",
      "197": "1",
      "199": "1",
      "170": "1",
      "101": "1",
      "105": "1"
    },
    "5": {
      "216": "1",
      "214": "1",
      "212": "1",
      "210": "1",
      "181": "1",
      "179": "1",
      "220": "1",
      "218": "1",
      "187": "1",
      "185": "1",
      "183": "1",
      "154": "1",
      "152": "1",
      "150": "1",
      "148": "1",
      "117": "1",
      "119": "1",
      "121": "1",
      "85": "1",
      "87": "1",
      "89": "1",
      "54": "1",
      "56": "1"
    },
    "6": {
      "193": "1",
      "195": "1",
      "197": "1",
      "199": "1",
      "201": "1",
      "203": "1",
      "205": "1",
      "163": "1",
      "165": "1",
      "167": "1",
      "169": "1",
      "171": "1",
      "133": "1",
      "135": "1",
      "137": "1",
      "103": "1",
      "101": "1",
      "105": "1",
      "69": "1",
      "71": "1",
      "73": "1",
      "38": "1",
      "40": "1"
    },
    "7": {
      "177": "1",
      "179": "1",
      "181": "1",
      "183": "1",
      "185": "1",
      "187": "1",
      "189": "1",
      "147": "1",
      "149": "1",
      "151": "1",
      "153": "1",
      "155": "1",
      "116": "1",
      "118": "1",
      "120": "1",
      "122": "1",
      "84": "1",
      "86": "1",
      "88": "1",
      "90": "1",
      "53": "1",
      "55": "1",
      "57": "1",
      "23": "1"
    }
  },
  "TileItemArray": [],
  "TotalItemNum": 13,
  "MoveVect": [
    0.0,
    0.0
  ],
  "TileTotalNum": 0,
  "TileLevelHardType": "Normal",
  "TotalCount": 111
}