{
  "AllLayerTileDict": {
    "1": {
      "212": 1,
      "214": 1,
      "216": 1,
      "218": 1,
      "179": 1,
      "181": 1,
      "183": 1,
      "185": 1,
      "187": 1,
      "155": 1,
      "153": 1,
      "151": 1,
      "149": 1,
      "147": 1,
      "210": 1,
      "189": 1,
      "115": 1,
      "117": 1,
      "119": 1,
      "121": 1,
      "123": 1,
      "177": 1,
      "220": 1,
      "157": 1,
      "84": 1,
      "86": 1,
      "88": 1,
      "90": 1,
      "145": 1,
      "54": 1,
      "56": 1,
      "22": 1,
      "24": 1,
      "58": 1,
      "52": 1
    },
    "2": {
      "131": 1,
      "170": 1,
      "168": 1,
      "166": 1,
      "195": 1,
      "172": 1,
      "164": 1,
      "197": 1,
      "199": 1,
      "201": 1,
      "203": 1,
      "162": 1,
      "133": 1,
      "135": 1,
      "137": 1,
      "139": 1,
      "100": 1,
      "102": 1,
      "104": 1,
      "106": 1,
      "69": 1,
      "71": 1,
      "73": 1,
      "37": 1,
      "39": 1,
      "41": 1
    },
    "3": {
      "116": 1,
      "118": 1,
      "120": 1,
      "122": 1,
      "183": 1,
      "153": 1,
      "149": 1,
      "155": 1,
      "151": 1,
      "185": 1,
      "147": 1,
      "187": 1,
      "181": 1,
      "179": 1,
      "85": 1,
      "87": 1,
      "89": 1,
      "53": 1,
      "55": 1,
      "57": 1
    },
    "4": {
      "164": 1,
      "166": 1,
      "168": 1,
      "170": 1,
      "132": 1,
      "134": 1,
      "136": 1,
      "138": 1,
      "101": 1,
      "103": 1,
      "105": 1,
      "69": 1,
      "71": 1,
      "73": 1
    },
    "5": {
      "149": 1,
      "151": 1,
      "153": 1,
      "117": 1,
      "119": 1,
      "121": 1,
      "88": 1,
      "86": 1
    },
    "6": {
      "134": 1,
      "136": 1,
      "102": 1,
      "104": 1
    },
    "7": {
      "119": 1
    }
  },
  "TileItemArray": [],
  "TotalItemNum": 15,
  "MoveVect": [
    0.0,
    0.0
  ],
  "TileTotalNum": 0,
  "TileLevelHardType": "Normal",
  "TotalCount": 108
}