{
  "AllLayerTileDict": {
    "1": {
      "17": "1",
      "49": "1",
      "81": "1",
      "203": "0",
      "113": "1",
      "43": "0",
      "145": "1",
      "125": "1",
      "177": "1",
      "139": "1",
      "209": "1",
      "107": "1",
      "67": "1",
      "35": "1",
      "99": "1",
      "131": "1",
      "163": "1",
      "195": "1",
      "149": "1",
      "117": "1",
      "85": "1",
      "53": "1",
      "181": "1",
      "71": "1",
      "103": "1",
      "135": "1",
      "167": "1",
      "89": "1",
      "121": "1",
      "153": "1"
    },
    "2": {
      "33": "1",
      "65": "1",
      "97": "1",
      "129": "1",
      "161": "1",
      "193": "1",
      "51": "1",
      "83": "1",
      "115": "1",
      "147": "1",
      "179": "1",
      "165": "1",
      "133": "1",
      "101": "1",
      "69": "1",
      "87": "1",
      "119": "1",
      "151": "1",
      "137": "1",
      "105": "1",
      "203": "0",
      "124": "1",
      "43": "0"
    },
    "3": {
      "49": "1",
      "81": "1",
      "113": "1",
      "145": "1",
      "177": "1",
      "67": "1",
      "99": "1",
      "131": "1",
      "163": "1",
      "85": "1",
      "117": "1",
      "149": "1",
      "103": "1",
      "135": "1",
      "121": "1",
      "123": "1",
      "43": "0",
      "203": "0"
    },
    "4": {
      "65": "1",
      "97": "1",
      "129": "1",
      "161": "1",
      "83": "1",
      "115": "1",
      "147": "1",
      "101": "1",
      "133": "1",
      "119": "1",
      "122": "1",
      "43": "0",
      "203": "0"
    },
    "5": {
      "81": "1",
      "113": "1",
      "145": "1",
      "99": "1",
      "131": "1",
      "117": "1",
      "120": "1",
      "123": "1",
      "43": "0",
      "203": "0"
    },
    "6": {
      "97": "1",
      "129": "1",
      "115": "1",
      "118": "1",
      "121": "1",
      "124": "1",
      "43": "0",
      "203": "0"
    },
    "7": {
      "81": "1",
      "116": "1",
      "119": "1",
      "122": "1",
      "125": "1",
      "43": "0",
      "203": "0",
      "145": "1",
      "113": "1"
    },
    "8": {
      "43": "0",
      "203": "0",
      "81": "1",
      "145": "1",
      "124": "1",
      "121": "1",
      "118": "1",
      "115": "1",
      "113": "1"
    }
  },
  "TileItemArray": [],
  "TotalItemNum": 12,
  "MoveVect": [
    0.0,
    0.0
  ],
  "TileTotalNum": 0,
  "TileLevelHardType": "Normal",
  "TotalCount": 120
}