{
  "AllLayerTileDict": {
    "1": {
      "21": "1",
      "213": "1",
      "25": "1",
      "217": "1",
      "19": "1",
      "211": "1",
      "17": "1",
      "209": "1",
      "27": "1",
      "219": "1",
      "29": "1",
      "221": "1",
      "53": "1",
      "181": "1",
      "55": "1",
      "183": "1",
      "57": "1",
      "185": "1",
      "87": "1",
      "151": "1",
      "85": "1",
      "149": "1",
      "89": "1",
      "153": "1",
      "117": "1",
      "119": "1",
      "121": "1"
    },
    "2": {
      "33": "1",
      "193": "1",
      "35": "1",
      "195": "1",
      "37": "1",
      "197": "1",
      "41": "1",
      "201": "1",
      "43": "1",
      "203": "1",
      "45": "1",
      "205": "1",
      "69": "1",
      "71": "1",
      "73": "1",
      "101": "1",
      "103": "1",
      "105": "1",
      "133": "1",
      "135": "1",
      "137": "1",
      "165": "1",
      "167": "1",
      "169": "1"
    },
    "3": {
      "49": "1",
      "177": "1",
      "51": "1",
      "179": "1",
      "53": "1",
      "181": "1",
      "57": "1",
      "185": "1",
      "59": "1",
      "187": "1",
      "61": "1",
      "189": "1",
      "85": "1",
      "87": "1",
      "89": "1",
      "117": "1",
      "119": "1",
      "121": "1",
      "149": "1",
      "151": "1",
      "153": "1"
    },
    "4": {
      "65": "1",
      "161": "1",
      "67": "1",
      "163": "1",
      "69": "1",
      "165": "1",
      "73": "1",
      "169": "1",
      "75": "1",
      "171": "1",
      "77": "1",
      "173": "1",
      "101": "1",
      "103": "1",
      "105": "1",
      "133": "1",
      "135": "1",
      "137": "1"
    },
    "5": {
      "81": "1",
      "145": "1",
      "83": "1",
      "147": "1",
      "85": "1",
      "149": "1",
      "89": "1",
      "153": "1",
      "91": "1",
      "155": "1",
      "93": "1",
      "157": "1",
      "117": "1",
      "119": "1",
      "121": "1"
    },
    "6": {
      "92": "1",
      "90": "1",
      "84": "1",
      "82": "1",
      "156": "1",
      "148": "1",
      "146": "1",
      "134": "1",
      "136": "1",
      "104": "1",
      "102": "1",
      "154": "1"
    },
    "7": {
      "83": "1",
      "91": "1",
      "147": "1",
      "155": "1",
      "118": "1",
      "120": "1"
    },
    "8": {
      "99": "1",
      "107": "1",
      "131": "1",
      "139": "1",
      "119": "1"
    },
    "9": {
      "114": "1",
      "124": "1",
      "103": "1",
      "135": "1"
    },
    "10": {
      "113": "1",
      "125": "1",
      "119": "1"
    }
  },
  "TileItemArray": [],
  "TotalItemNum": 14,
  "MoveVect": [
    0.0,
    0.0
  ],
  "TileTotalNum": 0,
  "TileLevelHardType": "Normal",
  "TotalCount": 135
}