{
  "AllLayerTileDict": {
    "1": {
      "17": 1,
      "19": 1,
      "21": 1,
      "23": 1,
      "221": 1,
      "219": 1,
      "217": 1,
      "215": 1,
      "50": 1,
      "52": 1,
      "54": 1,
      "56": 1,
      "188": 1,
      "186": 1,
      "184": 1,
      "182": 1,
      "83": 1,
      "87": 1,
      "85": 1,
      "89": 1,
      "155": 1,
      "153": 1,
      "151": 1,
      "149": 1,
      "116": 1,
      "118": 1,
      "120": 1,
      "122": 1
    },
    "2": {
      "201": 1,
      "205": 1,
      "203": 1,
      "199": 1,
      "170": 1,
      "168": 1,
      "166": 1,
      "172": 1,
      "106": 1,
      "104": 1,
      "137": 1,
      "139": 1,
      "133": 1,
      "135": 1,
      "102": 1,
      "67": 1,
      "100": 1,
      "73": 1,
      "71": 1,
      "69": 1,
      "34": 1,
      "36": 1,
      "40": 1,
      "38": 1
    },
    "3": {
      "189": 1,
      "187": 1,
      "185": 1,
      "183": 1,
      "150": 1,
      "152": 1,
      "154": 1,
      "156": 1,
      "123": 1,
      "121": 1,
      "119": 1,
      "117": 1,
      "51": 1,
      "90": 1,
      "88": 1,
      "86": 1,
      "84": 1,
      "57": 1,
      "55": 1,
      "53": 1
    },
    "4": {
      "167": 1,
      "169": 1,
      "171": 1,
      "173": 1,
      "140": 1,
      "138": 1,
      "136": 1,
      "134": 1,
      "105": 1,
      "107": 1,
      "103": 1,
      "101": 1,
      "70": 1,
      "72": 1,
      "74": 1,
      "68": 1
    },
    "5": {
      "151": 1,
      "153": 1,
      "155": 1,
      "157": 1,
      "124": 1,
      "122": 1,
      "120": 1,
      "118": 1,
      "89": 1,
      "91": 1,
      "87": 1,
      "85": 1
    },
    "6": {
      "135": 1,
      "137": 1,
      "139": 1,
      "141": 1,
      "108": 1,
      "106": 1,
      "104": 1,
      "102": 1
    },
    "7": {
      "124": 1,
      "121": 1,
      "119": 1
    }
  },
  "TileItemArray": [],
  "TotalItemNum": 10,
  "MoveVect": [
    0.0,
    0.0
  ],
  "TileTotalNum": 0,
  "TileLevelHardType": "Normal",
  "TotalCount": 111
}