{
  "AllLayerTileDict": {
    "1": {
      "29": 1,
      "27": 1,
      "25": 1,
      "60": 1,
      "58": 1,
      "56": 1,
      "91": 1,
      "87": 1,
      "89": 1,
      "122": 1,
      "120": 1,
      "118": 1,
      "153": 1,
      "151": 1,
      "149": 1,
      "184": 1,
      "182": 1,
      "180": 1,
      "23": 1,
      "54": 1,
      "85": 1,
      "116": 1,
      "147": 1,
      "178": 1,
      "209": 1,
      "211": 1,
      "213": 1,
      "215": 1
    },
    "2": {
      "193": 1,
      "162": 1,
      "131": 1,
      "100": 1,
      "69": 1,
      "38": 1,
      "195": 1,
      "164": 1,
      "133": 1,
      "102": 1,
      "71": 1,
      "40": 1,
      "197": 1,
      "166": 1,
      "135": 1,
      "104": 1,
      "73": 1,
      "42": 1,
      "199": 1,
      "168": 1,
      "137": 1,
      "106": 1,
      "75": 1,
      "44": 1
    },
    "3": {
      "57": 1,
      "59": 1,
      "55": 1,
      "53": 1,
      "90": 1,
      "88": 1,
      "86": 1,
      "84": 1,
      "121": 1,
      "119": 1,
      "117": 1,
      "115": 1,
      "152": 1,
      "150": 1,
      "148": 1,
      "146": 1,
      "183": 1,
      "181": 1,
      "179": 1,
      "177": 1
    },
    "4": {
      "69": 1,
      "71": 1,
      "73": 1,
      "75": 1,
      "100": 1,
      "102": 1,
      "104": 1,
      "106": 1,
      "131": 1,
      "133": 1,
      "135": 1,
      "137": 1,
      "162": 1,
      "164": 1,
      "166": 1,
      "168": 1
    },
    "5": {
      "85": 1,
      "87": 1,
      "89": 1,
      "91": 1,
      "116": 1,
      "118": 1,
      "120": 1,
      "122": 1,
      "147": 1,
      "149": 1,
      "151": 1,
      "153": 1
    },
    "6": {
      "101": 1,
      "103": 1,
      "105": 1,
      "107": 1,
      "132": 1,
      "134": 1,
      "136": 1,
      "138": 1
    },
    "7": {
      "117": 1,
      "119": 1,
      "121": 1,
      "123": 1
    },
    "8": {
      "118": 1,
      "120": 1,
      "122": 1
    },
    "9": {
      "119": 1,
      "121": 1
    }
  },
  "TileItemArray": [],
  "TotalItemNum": 12,
  "MoveVect": [
    0.0,
    0.0
  ],
  "TileTotalNum": 0,
  "TileLevelHardType": "Normal",
  "TotalCount": 117
}