{
  "AllLayerTileDict": {
    "1": {
      "183": 1,
      "18": 1,
      "28": 1,
      "150": 1,
      "152": 1,
      "51": 1,
      "59": 1,
      "216": 1,
      "214": 1,
      "84": 1,
      "90": 1,
      "117": 1,
      "121": 1,
      "113": 1,
      "125": 1,
      "145": 1,
      "157": 1,
      "177": 1,
      "189": 1,
      "209": 1,
      "221": 1,
      "131": 1,
      "139": 1,
      "195": 1,
      "203": 1,
      "164": 1,
      "170": 1,
      "20": 1,
      "22": 1,
      "24": 1,
      "26": 1,
      "53": 1,
      "55": 1,
      "57": 1,
      "86": 1,
      "119": 1,
      "88": 1
    },
    "2": {
      "35": 1,
      "37": 1,
      "39": 1,
      "41": 1,
      "43": 1,
      "68": 1,
      "70": 1,
      "72": 1,
      "74": 1,
      "101": 1,
      "103": 1,
      "105": 1,
      "134": 1,
      "136": 1,
      "167": 1,
      "130": 1,
      "140": 1,
      "162": 1,
      "172": 1,
      "194": 1,
      "204": 1,
      "148": 1,
      "154": 1,
      "197": 1,
      "201": 1
    },
    "3": {
      "52": 1,
      "54": 1,
      "56": 1,
      "58": 1,
      "85": 1,
      "87": 1,
      "89": 1,
      "118": 1,
      "120": 1,
      "151": 1,
      "179": 1,
      "187": 1,
      "147": 1,
      "155": 1,
      "185": 1,
      "181": 1
    },
    "4": {
      "69": 1,
      "71": 1,
      "73": 1,
      "102": 1,
      "104": 1,
      "135": 1,
      "148": 1,
      "154": 1,
      "180": 1,
      "186": 1,
      "166": 1,
      "168": 1
    },
    "5": {
      "86": 1,
      "88": 1,
      "119": 1,
      "165": 1,
      "169": 1,
      "151": 1
    },
    "6": {
      "103": 1,
      "135": 1,
      "166": 1,
      "168": 1
    },
    "7": {
      "119": 1,
      "151": 1
    }
  },
  "TileItemArray": [],
  "TotalItemNum": 11,
  "MoveVect": [
    0.0,
    0.0
  ],
  "TileTotalNum": 0,
  "TileLevelHardType": "Normal",
  "TotalCount": 102
}