{
  "AllLayerTileDict": {
    "1": {
      "34": "1",
      "44": "1",
      "66": "1",
      "76": "1",
      "68": "1",
      "74": "1",
      "36": "1",
      "42": "1",
      "134": "1",
      "166": "1",
      "168": "1",
      "136": "1"
    },
    "2": {
      "35": "1",
      "67": "1",
      "43": "1",
      "75": "1",
      "117": "1",
      "119": "1",
      "121": "1",
      "153": "1",
      "185": "1",
      "183": "1",
      "181": "1",
      "149": "1"
    },
    "3": {
      "36": "1",
      "68": "1",
      "42": "1",
      "74": "1",
      "100": "1",
      "106": "1",
      "136": "1",
      "166": "1",
      "168": "1",
      "134": "1"
    },
    "4": {
      "73": "1",
      "69": "1",
      "37": "1",
      "105": "1",
      "101": "1",
      "183": "1",
      "185": "1",
      "149": "1",
      "41": "1",
      "151": "1",
      "153": "1",
      "181": "1"
    },
    "5": {
      "104": "1",
      "38": "1",
      "40": "1",
      "196": "1",
      "72": "1",
      "70": "1",
      "138": "1",
      "136": "1",
      "134": "1",
      "132": "1",
      "164": "1",
      "166": "1",
      "168": "1",
      "170": "1",
      "198": "1",
      "102": "1",
      "200": "1",
      "202": "1"
    },
    "6": {
      "39": "1",
      "71": "1",
      "199": "1",
      "167": "1",
      "135": "1",
      "133": "1",
      "137": "1",
      "165": "1",
      "169": "1",
      "103": "1",
      "201": "1",
      "197": "1"
    },
    "7": {
      "86": "1",
      "184": "1",
      "56": "1",
      "88": "1",
      "152": "1",
      "54": "1",
      "150": "1",
      "118": "1",
      "182": "1",
      "120": "1",
      "180": "1",
      "154": "1",
      "122": "1",
      "116": "1",
      "186": "1",
      "148": "1"
    },
    "8": {
      "169": "1",
      "197": "1",
      "201": "1",
      "101": "1",
      "133": "1",
      "165": "1",
      "71": "1",
      "105": "1",
      "137": "1"
    },
    "9": {
      "84": "1",
      "116": "1",
      "148": "1",
      "180": "1",
      "152": "1",
      "150": "1",
      "120": "1",
      "118": "1",
      "186": "1",
      "154": "1",
      "122": "1",
      "90": "1",
      "86": "1",
      "88": "1",
      "182": "1",
      "184": "1",
      "114": "1",
      "146": "1",
      "178": "1",
      "124": "1",
      "156": "1",
      "188": "1"
    },
    "10": {
      "99": "1",
      "101": "1",
      "103": "1",
      "105": "1",
      "107": "1",
      "131": "1",
      "133": "1",
      "135": "1",
      "137": "1",
      "139": "1",
      "163": "1",
      "165": "1",
      "167": "1",
      "169": "1",
      "171": "1",
      "97": "1",
      "129": "1",
      "161": "1",
      "109": "1",
      "141": "1",
      "173": "1"
    }
  },
  "TileItemArray": [],
  "TotalItemNum": 11,
  "MoveVect": [
    0.0,
    0.0
  ],
  "TileTotalNum": 0,
  "TileLevelHardType": "Normal",
  "TotalCount": 144
}