{
  "AllLayerTileDict": {
    "1": {
      "34": 1,
      "36": 1,
      "196": 1,
      "38": 1,
      "198": 1,
      "40": 1,
      "200": 1,
      "42": 1,
      "202": 1,
      "44": 1,
      "66": 1,
      "76": 1,
      "99": 1,
      "131": 1,
      "107": 1,
      "139": 1,
      "68": 1,
      "164": 1,
      "74": 1,
      "170": 1,
      "101": 1,
      "133": 1,
      "105": 1,
      "137": 1,
      "103": 1,
      "135": 1
    },
    "2": {
      "50": 1,
      "52": 1,
      "54": 1,
      "56": 1,
      "58": 1,
      "60": 1,
      "88": 1,
      "86": 1,
      "84": 1,
      "82": 1,
      "90": 1,
      "92": 1,
      "115": 1,
      "117": 1,
      "119": 1,
      "121": 1,
      "123": 1,
      "148": 1,
      "150": 1,
      "152": 1,
      "154": 1,
      "180": 1,
      "182": 1,
      "184": 1,
      "186": 1
    },
    "3": {
      "67": 1,
      "69": 1,
      "71": 1,
      "73": 1,
      "75": 1,
      "99": 1,
      "101": 1,
      "103": 1,
      "105": 1,
      "107": 1,
      "132": 1,
      "134": 1,
      "136": 1,
      "138": 1,
      "164": 1,
      "166": 1,
      "168": 1,
      "170": 1
    },
    "4": {
      "84": 1,
      "86": 1,
      "88": 1,
      "90": 1,
      "116": 1,
      "118": 1,
      "120": 1,
      "122": 1,
      "148": 1,
      "150": 1,
      "152": 1,
      "154": 1
    },
    "5": {
      "100": 1,
      "102": 1,
      "104": 1,
      "106": 1,
      "132": 1,
      "134": 1,
      "136": 1,
      "138": 1
    },
    "6": {
      "84": 1,
      "86": 1,
      "88": 1,
      "90": 1,
      "148": 1,
      "150": 1,
      "152": 1,
      "154": 1,
      "116": 1,
      "118": 1,
      "120": 1,
      "122": 1
    },
    "7": {
      "67": 1,
      "69": 1,
      "71": 1,
      "73": 1,
      "75": 1,
      "99": 1,
      "101": 1,
      "103": 1,
      "105": 1,
      "107": 1,
      "131": 1,
      "133": 1,
      "135": 1,
      "137": 1,
      "139": 1,
      "164": 1,
      "166": 1,
      "170": 1,
      "168": 1
    }
  },
  "TileItemArray": [],
  "TotalItemNum": 12,
  "MoveVect": [
    0.0,
    0.0
  ],
  "TileTotalNum": 0,
  "TileLevelHardType": "Normal",
  "TotalCount": 120
}