{
  "AllLayerTileDict": {
    "1": {
      "17": 1,
      "29": 1,
      "19": 1,
      "27": 1,
      "21": 1,
      "25": 1,
      "23": 1,
      "54": 1,
      "56": 1,
      "68": 1,
      "74": 1,
      "82": 1,
      "92": 1,
      "113": 1,
      "125": 1,
      "145": 1,
      "157": 1,
      "177": 1,
      "189": 1,
      "209": 1,
      "221": 1,
      "187": 1,
      "179": 1,
      "147": 1,
      "155": 1,
      "116": 1,
      "122": 1,
      "102": 1,
      "104": 1
    },
    "2": {
      "34": 1,
      "36": 1,
      "38": 1,
      "40": 1,
      "42": 1,
      "44": 1,
      "70": 1,
      "72": 1,
      "83": 1,
      "91": 1,
      "114": 1,
      "124": 1,
      "146": 1,
      "156": 1,
      "178": 1,
      "188": 1,
      "210": 1,
      "220": 1,
      "103": 1,
      "117": 1,
      "121": 1
    },
    "3": {
      "51": 1,
      "53": 1,
      "55": 1,
      "57": 1,
      "59": 1,
      "86": 1,
      "84": 1,
      "115": 1,
      "90": 1,
      "147": 1,
      "155": 1,
      "179": 1,
      "187": 1,
      "211": 1,
      "219": 1,
      "88": 1,
      "118": 1,
      "120": 1,
      "123": 1
    },
    "4": {
      "68": 1,
      "70": 1,
      "72": 1,
      "74": 1,
      "101": 1,
      "105": 1,
      "132": 1,
      "138": 1,
      "164": 1,
      "170": 1,
      "196": 1,
      "202": 1,
      "103": 1
    },
    "5": {
      "88": 1,
      "86": 1,
      "84": 1,
      "147": 1,
      "179": 1,
      "115": 1,
      "123": 1,
      "187": 1,
      "155": 1,
      "90": 1,
      "118": 1,
      "150": 1,
      "182": 1,
      "120": 1,
      "152": 1,
      "184": 1,
      "214": 1,
      "216": 1
    },
    "6": {
      "108": 1,
      "98": 1,
      "106": 1,
      "104": 1,
      "100": 1,
      "102": 1,
      "132": 1,
      "138": 1,
      "164": 1,
      "170": 1,
      "196": 1,
      "202": 1,
      "135": 1,
      "167": 1,
      "199": 1
    },
    "7": {
      "99": 1,
      "101": 1,
      "103": 1,
      "105": 1,
      "107": 1,
      "148": 1,
      "151": 1,
      "154": 1,
      "186": 1,
      "183": 1,
      "180": 1
    }
  },
  "TileItemArray": [],
  "TotalItemNum": 9,
  "MoveVect": [
    0.0,
    0.0
  ],
  "TileTotalNum": 0,
  "TileLevelHardType": "Normal",
  "TotalCount": 126
}