{
  "AllLayerTileDict": {
    "1": {
      "23": 1,
      "54": 1,
      "56": 1,
      "85": 1,
      "87": 1,
      "89": 1,
      "116": 1,
      "118": 1,
      "120": 1,
      "122": 1,
      "147": 1,
      "149": 1,
      "151": 1,
      "153": 1,
      "155": 1,
      "178": 1,
      "180": 1,
      "182": 1,
      "184": 1,
      "186": 1,
      "188": 1,
      "209": 1,
      "211": 1,
      "213": 1,
      "215": 1,
      "217": 1,
      "219": 1,
      "221": 1,
      "33": 0,
      "65": 0,
      "97": 0,
      "45": -1,
      "77": -1,
      "109": -1
    },
    "2": {
      "39": 1,
      "70": 1,
      "72": 1,
      "101": 1,
      "103": 1,
      "105": 1,
      "132": 1,
      "134": 1,
      "136": 1,
      "138": 1,
      "169": 1,
      "167": 1,
      "165": 1,
      "163": 1,
      "171": 1,
      "194": 1,
      "196": 1,
      "198": 1,
      "200": 1,
      "202": 1,
      "204": 1,
      "33": 0,
      "65": 0,
      "97": 0,
      "45": -1,
      "77": -1,
      "109": -1
    },
    "3": {
      "55": 1,
      "86": 1,
      "88": 1,
      "117": 1,
      "119": 1,
      "121": 1,
      "148": 1,
      "150": 1,
      "152": 1,
      "154": 1,
      "179": 1,
      "181": 1,
      "183": 1,
      "185": 1,
      "187": 1,
      "33": 0,
      "65": 0,
      "97": 0,
      "45": -1,
      "77": -1,
      "109": -1
    },
    "4": {
      "71": 1,
      "102": 1,
      "104": 1,
      "133": 1,
      "135": 1,
      "137": 1,
      "164": 1,
      "166": 1,
      "168": 1,
      "170": 1,
      "33": 0,
      "65": 0,
      "97": 0,
      "45": -1,
      "77": -1,
      "109": -1
    },
    "5": {
      "87": 1,
      "118": 1,
      "120": 1,
      "149": 1,
      "151": 1,
      "153": 1,
      "33": 0,
      "65": 0,
      "97": 0,
      "45": -1,
      "77": -1,
      "109": -1
    },
    "6": {
      "133": 1,
      "103": 1,
      "135": 1,
      "45": -1,
      "33": 0,
      "77": -1,
      "65": 0,
      "109": -1,
      "97": 0,
      "137": 1
    }
  },
  "TileItemArray": [],
  "TotalItemNum": 14,
  "MoveVect": [
    0.0,
    0.0
  ],
  "TileTotalNum": 0,
  "TileLevelHardType": "Normal",
  "TotalCount": 120
}