{
  "AllLayerTileDict": {
    "1": {
      "53": 1,
      "57": 1,
      "85": 1,
      "89": 1,
      "117": 1,
      "121": 1,
      "149": 1,
      "153": 1,
      "181": 1,
      "185": 1
    },
    "2": {
      "68": 1,
      "164": 1,
      "70": 1,
      "166": 1,
      "72": 1,
      "168": 1,
      "74": 1,
      "170": 1,
      "116": 1,
      "118": 1,
      "120": 1,
      "122": 1
    },
    "3": {
      "52": 1,
      "84": 1,
      "116": 1,
      "148": 1,
      "180": 1,
      "58": 1,
      "90": 1,
      "122": 1,
      "154": 1,
      "186": 1,
      "55": 1,
      "87": 1,
      "119": 1,
      "151": 1,
      "183": 1
    },
    "4": {
      "67": 1,
      "69": 1,
      "71": 1,
      "73": 1,
      "75": 1,
      "163": 1,
      "165": 1,
      "167": 1,
      "169": 1,
      "171": 1,
      "115": 1,
      "117": 1,
      "119": 1,
      "121": 1,
      "123": 1
    },
    "5": {
      "50": 1,
      "82": 1,
      "114": 1,
      "146": 1,
      "178": 1,
      "60": 1,
      "92": 1,
      "124": 1,
      "156": 1,
      "188": 1,
      "54": 1,
      "86": 1,
      "118": 1,
      "150": 1,
      "182": 1,
      "56": 1,
      "88": 1,
      "120": 1,
      "152": 1,
      "184": 1
    },
    "6": {
      "65": 1,
      "161": 1,
      "67": 1,
      "163": 1,
      "69": 1,
      "165": 1,
      "103": 1,
      "39": 1,
      "73": 1,
      "169": 1,
      "75": 1,
      "171": 1,
      "77": 1,
      "173": 1,
      "113": 1,
      "115": 1,
      "117": 1,
      "71": 1,
      "121": 1,
      "123": 1,
      "125": 1,
      "135": 1,
      "167": 1,
      "199": 1
    }
  },
  "TileItemArray": [],
  "TotalItemNum": 10,
  "MoveVect": [
    0.0,
    0.0
  ],
  "TileTotalNum": 0,
  "TileLevelHardType": "Normal",
  "TotalCount": 96
}