{
  "AllLayerTileDict": {
    "1": {
      "153": "1",
      "149": "1",
      "89": "1",
      "85": "1",
      "119": "1",
      "179": "1",
      "59": "1"
    },
    "2": {
      "68": "1",
      "70": "1",
      "100": "1",
      "102": "1",
      "170": "1",
      "168": "1",
      "136": "1",
      "138": "1",
      "134": "1",
      "104": "1",
      "74": "1",
      "164": "1"
    },
    "3": {
      "85": "1",
      "153": "1",
      "183": "1",
      "187": "1",
      "123": "1",
      "119": "1",
      "51": "1",
      "55": "1",
      "115": "1",
      "59": "1",
      "179": "1"
    },
    "4": {
      "68": "1",
      "66": "1",
      "34": "1",
      "36": "1",
      "204": "1",
      "202": "1",
      "170": "1",
      "172": "1",
      "136": "1",
      "104": "1",
      "102": "1",
      "134": "1",
      "100": "1",
      "70": "1",
      "168": "1",
      "138": "1",
      "164": "1",
      "194": "1",
      "74": "1",
      "44": "1"
    },
    "5": {
      "51": "1",
      "85": "1",
      "119": "1",
      "153": "1",
      "187": "1",
      "149": "1",
      "89": "1",
      "59": "1",
      "179": "1"
    },
    "6": {
      "164": "1",
      "166": "1",
      "132": "1",
      "134": "1",
      "104": "1",
      "106": "1",
      "72": "1",
      "74": "1",
      "68": "1",
      "170": "1"
    },
    "7": {
      "51": "1",
      "53": "1",
      "83": "1",
      "85": "1",
      "153": "1",
      "155": "1",
      "187": "1",
      "185": "1",
      "89": "1",
      "149": "1",
      "119": "1",
      "59": "1",
      "179": "1"
    },
    "8": {
      "134": "1",
      "104": "1",
      "34": "1",
      "68": "1",
      "102": "1",
      "136": "1",
      "170": "1",
      "204": "1",
      "166": "1",
      "164": "1",
      "132": "1",
      "106": "1",
      "74": "1",
      "72": "1"
    },
    "9": {
      "149": "1",
      "153": "1",
      "187": "1",
      "85": "1",
      "51": "1",
      "83": "1",
      "53": "1",
      "185": "1",
      "155": "1",
      "89": "1"
    },
    "10": {
      "66": "1",
      "36": "1",
      "34": "1",
      "68": "1",
      "170": "1",
      "202": "1",
      "204": "1",
      "172": "1",
      "102": "1",
      "136": "1",
      "104": "1",
      "134": "1",
      "100": "1",
      "70": "1",
      "168": "1",
      "138": "1"
    },
    "11": {
      "119": "1",
      "151": "1",
      "121": "1",
      "117": "1",
      "87": "1",
      "187": "1",
      "51": "1",
      "85": "1",
      "153": "1",
      "83": "1",
      "53": "1",
      "185": "1",
      "155": "1",
      "183": "1",
      "217": "1",
      "219": "1",
      "221": "1",
      "189": "1",
      "157": "1",
      "17": "1",
      "19": "1",
      "21": "1",
      "49": "1",
      "81": "1",
      "123": "1"
    }
  },
  "TileItemArray": [],
  "TotalItemNum": 12,
  "MoveVect": [
    0.0,
    0.0
  ],
  "TileTotalNum": 0,
  "TileLevelHardType": "Normal",
  "TotalCount": 147
}