{
  "AllLayerTileDict": {
    "1": {
      "35": "1",
      "43": "1",
      "67": "1",
      "75": "1",
      "99": "1",
      "107": "1",
      "86": "1",
      "88": "1",
      "118": "1",
      "120": "1",
      "150": "1",
      "152": "1",
      "182": "1",
      "184": "1"
    },
    "2": {
      "98": "1",
      "100": "1",
      "102": "1",
      "104": "1",
      "106": "1",
      "108": "1",
      "66": "1",
      "68": "1",
      "70": "1",
      "72": "1",
      "74": "1",
      "76": "1",
      "34": "1",
      "44": "1",
      "36": "1",
      "42": "1",
      "135": "1",
      "167": "1"
    },
    "3": {
      "51": "1",
      "59": "1",
      "91": "1",
      "83": "1",
      "87": "1",
      "151": "1"
    },
    "4": {
      "67": "1",
      "75": "1",
      "103": "1",
      "167": "1"
    },
    "5": {
      "83": "1",
      "91": "1",
      "119": "1",
      "183": "1"
    },
    "6": {
      "99": "1",
      "107": "1",
      "135": "1",
      "199": "1",
      "67": "1",
      "75": "1",
      "103": "1",
      "167": "1"
    },
    "7": {
      "114": "1",
      "116": "1",
      "150": "1",
      "152": "1",
      "122": "1",
      "124": "1",
      "198": "1",
      "200": "1",
      "82": "1",
      "84": "1",
      "90": "1",
      "92": "1"
    },
    "8": {
      "97": "1",
      "109": "1",
      "99": "1",
      "107": "1",
      "101": "1",
      "105": "1",
      "149": "1",
      "151": "1",
      "153": "1",
      "181": "1",
      "183": "1",
      "185": "1"
    },
    "9": {
      "113": "1",
      "115": "1",
      "117": "1",
      "121": "1",
      "123": "1",
      "125": "1",
      "164": "1",
      "166": "1",
      "168": "1",
      "170": "1"
    },
    "10": {
      "129": "1",
      "131": "1",
      "133": "1",
      "137": "1",
      "139": "1",
      "141": "1",
      "180": "1",
      "182": "1",
      "184": "1",
      "186": "1"
    },
    "11": {
      "145": "1",
      "147": "1",
      "149": "1",
      "153": "1",
      "155": "1",
      "157": "1",
      "196": "1",
      "198": "1",
      "200": "1",
      "202": "1"
    },
    "12": {
      "130": "1",
      "132": "1",
      "138": "1",
      "140": "1",
      "181": "1",
      "183": "1",
      "185": "1"
    },
    "13": {
      "202": "1",
      "196": "1",
      "167": "1",
      "165": "1",
      "198": "1",
      "200": "1",
      "169": "1",
      "114": "1",
      "116": "1",
      "122": "1",
      "124": "1"
    }
  },
  "TileItemArray": [],
  "TotalItemNum": 11,
  "MoveVect": [
    0.0,
    0.0
  ],
  "TileTotalNum": 0,
  "TileLevelHardType": "Normal",
  "TotalCount": 126
}