{
  "AllLayerTileDict": {
    "1": {
      "197": 1,
      "37": 1,
      "201": 1,
      "41": 1,
      "199": 1,
      "39": 1
    },
    "2": {
      "52": 1,
      "180": 1,
      "38": 1,
      "198": 1,
      "40": 1,
      "200": 1,
      "58": 1,
      "186": 1
    },
    "3": {
      "69": 1,
      "165": 1,
      "67": 1,
      "163": 1,
      "73": 1,
      "169": 1,
      "75": 1,
      "171": 1,
      "39": 1,
      "199": 1
    },
    "4": {
      "82": 1,
      "146": 1,
      "68": 1,
      "164": 1,
      "70": 1,
      "166": 1,
      "72": 1,
      "168": 1,
      "74": 1,
      "170": 1,
      "92": 1,
      "156": 1,
      "38": 1,
      "40": 1,
      "198": 1,
      "200": 1
    },
    "5": {
      "83": 1,
      "147": 1,
      "85": 1,
      "149": 1,
      "87": 1,
      "151": 1,
      "89": 1,
      "153": 1,
      "91": 1,
      "155": 1,
      "55": 1,
      "183": 1
    },
    "6": {
      "98": 1,
      "130": 1,
      "100": 1,
      "132": 1,
      "102": 1,
      "134": 1,
      "104": 1,
      "136": 1,
      "106": 1,
      "138": 1,
      "108": 1,
      "140": 1,
      "70": 1,
      "166": 1,
      "72": 1,
      "168": 1
    },
    "7": {
      "87": 1,
      "115": 1,
      "123": 1,
      "151": 1
    },
    "8": {
      "102": 1,
      "104": 1,
      "70": 1,
      "72": 1,
      "166": 1,
      "168": 1,
      "130": 1,
      "132": 1,
      "138": 1,
      "140": 1
    },
    "9": {
      "87": 1,
      "131": 1,
      "139": 1,
      "183": 1,
      "151": 1
    },
    "10": {
      "70": 1,
      "72": 1,
      "102": 1,
      "104": 1,
      "114": 1,
      "124": 1,
      "116": 1,
      "122": 1,
      "146": 1,
      "156": 1,
      "148": 1,
      "154": 1
    }
  },
  "TileItemArray": [],
  "TotalItemNum": 10,
  "MoveVect": [
    0.0,
    0.0
  ],
  "TileTotalNum": 0,
  "TileLevelHardType": "Normal",
  "TotalCount": 99
}