{
  "AllLayerTileDict": {
    "1": {
      "17": 1,
      "49": 1,
      "81": 1,
      "113": 1,
      "145": 1,
      "177": 1,
      "209": 1,
      "57": 1,
      "87": 1,
      "91": 1,
      "121": 1,
      "89": 1,
      "151": 1,
      "153": 1,
      "155": 1,
      "185": 1
    },
    "2": {
      "18": 1,
      "50": 1,
      "82": 1,
      "114": 1,
      "146": 1,
      "178": 1,
      "210": 1,
      "72": 1,
      "74": 1,
      "106": 1,
      "104": 1,
      "136": 1,
      "168": 1,
      "170": 1,
      "138": 1
    },
    "3": {
      "19": 1,
      "51": 1,
      "83": 1,
      "115": 1,
      "147": 1,
      "179": 1,
      "211": 1,
      "89": 1,
      "153": 1
    },
    "4": {
      "20": 1,
      "52": 1,
      "84": 1,
      "116": 1,
      "148": 1,
      "180": 1,
      "212": 1,
      "72": 1,
      "74": 1,
      "106": 1,
      "138": 1,
      "170": 1,
      "168": 1,
      "136": 1,
      "104": 1
    },
    "5": {
      "57": 1,
      "89": 1,
      "121": 1,
      "153": 1,
      "185": 1,
      "151": 1,
      "155": 1,
      "87": 1,
      "91": 1,
      "163": 1,
      "67": 1,
      "195": 1,
      "99": 1,
      "131": 1,
      "35": 1
    },
    "6": {
      "72": 1,
      "168": 1,
      "74": 1,
      "170": 1,
      "106": 1,
      "138": 1,
      "104": 1,
      "136": 1,
      "34": 1,
      "66": 1,
      "130": 1,
      "98": 1,
      "162": 1,
      "194": 1
    },
    "7": {
      "89": 1,
      "153": 1,
      "33": 1,
      "65": 1,
      "97": 1,
      "129": 1,
      "161": 1,
      "193": 1
    },
    "8": {
      "50": 1,
      "82": 1,
      "114": 1,
      "146": 1,
      "178": 1,
      "72": 1,
      "104": 1,
      "106": 1,
      "74": 1,
      "136": 1,
      "168": 1,
      "170": 1,
      "138": 1
    },
    "9": {
      "51": 1,
      "83": 1,
      "115": 1,
      "147": 1,
      "179": 1,
      "89": 1,
      "57": 1,
      "121": 1,
      "153": 1,
      "185": 1,
      "151": 1,
      "155": 1,
      "87": 1,
      "91": 1
    },
    "10": {
      "52": 1,
      "84": 1,
      "116": 1,
      "148": 1,
      "180": 1
    },
    "11": {
      "67": 1,
      "99": 1,
      "131": 1,
      "163": 1
    },
    "12": {
      "66": 1,
      "98": 1,
      "130": 1,
      "162": 1
    }
  },
  "TileItemArray": [],
  "TotalItemNum": 9,
  "MoveVect": [
    1.0,
    0.0
  ],
  "TileTotalNum": 0,
  "TileLevelHardType": "Normal",
  "TotalCount": 132
}