{
  "AllLayerTileDict": {
    "1": {
      "83": "1",
      "19": "1",
      "51": "1",
      "85": "1",
      "87": "1",
      "89": "1",
      "91": "1",
      "59": "1",
      "27": "1",
      "25": "1",
      "21": "1",
      "23": "1",
      "53": "1",
      "55": "1",
      "57": "1"
    },
    "2": {
      "36": "1",
      "38": "1",
      "40": "1",
      "42": "1",
      "72": "1",
      "70": "1",
      "68": "1",
      "74": "1",
      "106": "1",
      "104": "1",
      "102": "1",
      "100": "1"
    },
    "3": {
      "53": "1",
      "85": "1",
      "117": "1",
      "119": "1",
      "121": "1",
      "89": "1",
      "57": "1",
      "55": "1",
      "87": "1"
    },
    "4": {
      "70": "1",
      "102": "1",
      "104": "1",
      "72": "1"
    },
    "5": {
      "87": "1",
      "119": "1",
      "151": "1",
      "117": "1",
      "121": "1"
    },
    "6": {
      "102": "1",
      "104": "1",
      "136": "1",
      "134": "1"
    },
    "7": {
      "119": "1"
    },
    "8": {
      "102": "1",
      "104": "1",
      "136": "1",
      "134": "1"
    },
    "9": {
      "87": "1",
      "119": "1",
      "151": "1",
      "117": "1",
      "121": "1",
      "115": "1",
      "113": "1",
      "83": "1",
      "147": "1",
      "123": "1",
      "125": "1",
      "91": "1",
      "155": "1"
    },
    "10": {
      "98": "1",
      "100": "1",
      "132": "1",
      "130": "1",
      "106": "1",
      "138": "1",
      "140": "1",
      "108": "1",
      "102": "1",
      "104": "1",
      "134": "1",
      "136": "1"
    },
    "11": {
      "115": "1",
      "119": "1",
      "123": "1"
    },
    "12": {
      "131": "1",
      "137": "1",
      "135": "1",
      "133": "1",
      "139": "1",
      "165": "1",
      "169": "1",
      "101": "1",
      "105": "1"
    },
    "13": {
      "116": "1",
      "118": "1",
      "120": "1",
      "122": "1",
      "154": "1",
      "152": "1",
      "150": "1",
      "148": "1"
    },
    "14": {
      "133": "1",
      "137": "1",
      "163": "1",
      "171": "1",
      "197": "1",
      "201": "1",
      "165": "1",
      "167": "1",
      "169": "1"
    },
    "15": {
      "148": "1",
      "150": "1",
      "182": "1",
      "180": "1",
      "152": "1",
      "184": "1",
      "186": "1",
      "154": "1"
    },
    "16": {
      "165": "1",
      "169": "1",
      "133": "1",
      "197": "1",
      "167": "1",
      "171": "1",
      "163": "1",
      "137": "1",
      "201": "1"
    },
    "17": {
      "148": "1",
      "180": "1",
      "182": "1",
      "150": "1",
      "184": "1",
      "152": "1",
      "186": "1",
      "154": "1",
      "146": "1",
      "178": "1",
      "156": "1",
      "188": "1"
    },
    "18": {
      "163": "1",
      "167": "1",
      "171": "1",
      "131": "1",
      "161": "1",
      "165": "1",
      "169": "1",
      "173": "1",
      "139": "1",
      "203": "1",
      "195": "1",
      "135": "1",
      "199": "1"
    }
  },
  "TileItemArray": [],
  "TotalItemNum": 7,
  "MoveVect": [
    0.0,
    0.5
  ],
  "TileTotalNum": 0,
  "TileLevelHardType": "Normal",
  "TotalCount": 150
}