{
  "AllLayerTileDict": {
    "1": {
      "57": 1,
      "55": 1,
      "53": 1,
      "23": 1,
      "113": 1,
      "91": 1,
      "89": 1,
      "87": 1,
      "85": 1,
      "83": 1,
      "115": 1,
      "117": 1,
      "119": 1,
      "121": 1,
      "123": 1,
      "125": 1
    },
    "2": {
      "134": 1,
      "72": 1,
      "102": 1,
      "70": 1,
      "198": 1,
      "166": 1,
      "104": 1,
      "136": 1,
      "168": 1,
      "200": 1,
      "98": 1,
      "130": 1,
      "162": 1,
      "194": 1,
      "108": 1,
      "140": 1,
      "172": 1,
      "204": 1,
      "38": 1,
      "40": 1
    },
    "3": {
      "55": 1,
      "85": 1,
      "87": 1,
      "89": 1,
      "115": 1,
      "117": 1,
      "119": 1,
      "121": 1,
      "123": 1,
      "145": 1,
      "147": 1,
      "149": 1,
      "151": 1,
      "153": 1,
      "155": 1,
      "157": 1,
      "179": 1,
      "187": 1
    },
    "4": {
      "194": 1,
      "162": 1,
      "130": 1,
      "70": 1,
      "102": 1,
      "134": 1,
      "166": 1,
      "198": 1,
      "200": 1,
      "168": 1,
      "136": 1,
      "104": 1,
      "72": 1,
      "140": 1,
      "172": 1,
      "204": 1
    },
    "5": {
      "87": 1,
      "117": 1,
      "119": 1,
      "121": 1,
      "147": 1,
      "151": 1,
      "149": 1,
      "153": 1,
      "155": 1,
      "187": 1,
      "185": 1,
      "183": 1,
      "181": 1,
      "179": 1,
      "177": 1,
      "189": 1
    },
    "6": {
      "102": 1,
      "134": 1,
      "166": 1,
      "198": 1,
      "200": 1,
      "168": 1,
      "136": 1,
      "104": 1,
      "162": 1,
      "194": 1,
      "172": 1,
      "204": 1
    },
    "7": {
      "119": 1,
      "151": 1,
      "183": 1,
      "215": 1,
      "149": 1,
      "153": 1,
      "179": 1,
      "181": 1,
      "185": 1,
      "187": 1,
      "209": 1,
      "211": 1,
      "213": 1,
      "217": 1,
      "219": 1,
      "221": 1
    }
  },
  "TileItemArray": [],
  "TotalItemNum": 11,
  "MoveVect": [
    0.0,
    0.0
  ],
  "TileTotalNum": 0,
  "TileLevelHardType": "Normal",
  "TotalCount": 114
}