{
  "AllLayerTileDict": {
    "1": {
      "17": "1",
      "50": "1",
      "83": "1",
      "116": "1",
      "149": "1",
      "182": "1",
      "215": "1",
      "213": "1",
      "211": "1",
      "209": "1",
      "180": "1",
      "178": "1",
      "147": "1",
      "114": "1",
      "145": "1",
      "81": "1",
      "29": "1",
      "27": "1",
      "25": "1",
      "23": "1",
      "56": "1",
      "89": "1",
      "122": "1",
      "155": "1",
      "188": "1",
      "221": "1",
      "58": "1",
      "60": "1",
      "91": "1",
      "93": "1",
      "124": "1",
      "157": "1"
    },
    "2": {
      "166": "1",
      "193": "1",
      "195": "1",
      "199": "1",
      "197": "1",
      "162": "1",
      "164": "1",
      "133": "1",
      "131": "1",
      "129": "1",
      "100": "1",
      "98": "1",
      "67": "1",
      "65": "1",
      "34": "1",
      "45": "1",
      "43": "1",
      "39": "1",
      "41": "1",
      "72": "1",
      "74": "1",
      "76": "1",
      "105": "1",
      "107": "1",
      "109": "1",
      "138": "1",
      "140": "1",
      "171": "1",
      "173": "1",
      "204": "1"
    },
    "3": {
      "177": "1",
      "179": "1",
      "181": "1",
      "183": "1",
      "150": "1",
      "148": "1",
      "146": "1",
      "117": "1",
      "115": "1",
      "113": "1",
      "51": "1",
      "84": "1",
      "82": "1",
      "55": "1",
      "57": "1",
      "59": "1",
      "61": "1",
      "88": "1",
      "90": "1",
      "92": "1",
      "121": "1",
      "123": "1",
      "125": "1",
      "154": "1",
      "156": "1",
      "187": "1"
    },
    "4": {
      "167": "1",
      "165": "1",
      "161": "1",
      "163": "1",
      "134": "1",
      "132": "1",
      "130": "1",
      "101": "1",
      "99": "1",
      "97": "1",
      "68": "1",
      "66": "1",
      "71": "1",
      "73": "1",
      "75": "1",
      "77": "1",
      "104": "1",
      "106": "1",
      "108": "1",
      "137": "1",
      "139": "1",
      "141": "1",
      "170": "1",
      "172": "1"
    },
    "5": {
      "147": "1",
      "145": "1",
      "151": "1",
      "149": "1",
      "118": "1",
      "116": "1",
      "114": "1",
      "85": "1",
      "83": "1",
      "81": "1",
      "87": "1",
      "89": "1",
      "91": "1",
      "93": "1",
      "120": "1",
      "122": "1",
      "124": "1",
      "153": "1",
      "155": "1",
      "157": "1"
    }
  },
  "TileItemArray": [],
  "TotalItemNum": 15,
  "MoveVect": [
    0.0,
    0.0
  ],
  "TileTotalNum": 0,
  "TileLevelHardType": "Normal",
  "TotalCount": 132
}