{
  "AllLayerTileDict": {
    "1": {
      "34": 1,
      "44": 1,
      "67": 1,
      "75": 1,
      "100": 1,
      "106": 1,
      "118": 1,
      "120": 1,
      "150": 1,
      "152": 1,
      "201": 1,
      "197": 1
    },
    "2": {
      "135": 1,
      "180": 1,
      "186": 1,
      "182": 1,
      "184": 1,
      "214": 1,
      "216": 1,
      "212": 1,
      "218": 1,
      "18": 1,
      "28": 1,
      "50": 1,
      "60": 1,
      "82": 1,
      "92": 1,
      "101": 1,
      "105": 1
    },
    "3": {
      "34": 1,
      "44": 1,
      "66": 1,
      "76": 1,
      "98": 1,
      "108": 1,
      "118": 1,
      "120": 1,
      "196": 1,
      "198": 1,
      "200": 1,
      "202": 1
    },
    "4": {
      "82": 1,
      "92": 1,
      "50": 1,
      "60": 1,
      "114": 1,
      "124": 1,
      "133": 1,
      "135": 1,
      "137": 1,
      "195": 1,
      "197": 1,
      "199": 1,
      "201": 1,
      "203": 1
    },
    "5": {
      "66": 1,
      "76": 1,
      "98": 1,
      "108": 1,
      "130": 1,
      "140": 1,
      "134": 1,
      "136": 1,
      "196": 1,
      "198": 1,
      "200": 1,
      "202": 1
    },
    "6": {
      "82": 1,
      "92": 1,
      "114": 1,
      "124": 1,
      "146": 1,
      "156": 1,
      "135": 1,
      "180": 1,
      "182": 1,
      "184": 1,
      "186": 1
    },
    "7": {
      "98": 1,
      "108": 1,
      "130": 1,
      "140": 1,
      "162": 1,
      "172": 1,
      "196": 1,
      "198": 1,
      "200": 1,
      "202": 1,
      "118": 1,
      "120": 1,
      "152": 1,
      "150": 1
    },
    "8": {
      "135": 1,
      "197": 1,
      "199": 1,
      "201": 1
    }
  },
  "TileItemArray": [],
  "TotalItemNum": 10,
  "MoveVect": [
    0.0,
    0.0
  ],
  "TileTotalNum": 0,
  "TileLevelHardType": "Normal",
  "TotalCount": 96
}