{
  "AllLayerTileDict": {
    "1": {
      "69": 1,
      "165": 1,
      "71": 1,
      "167": 1,
      "73": 1,
      "169": 1,
      "101": 1,
      "133": 1,
      "137": 1,
      "105": 1
    },
    "2": {
      "85": 1,
      "149": 1,
      "87": 1,
      "151": 1,
      "89": 1,
      "153": 1,
      "117": 1,
      "121": 1
    },
    "3": {
      "102": 1,
      "104": 1,
      "136": 1,
      "134": 1
    },
    "4": {
      "119": 1,
      "150": 1,
      "152": 1,
      "117": 1,
      "86": 1,
      "88": 1,
      "121": 1
    },
    "5": {
      "102": 1,
      "104": 1,
      "136": 1,
      "134": 1
    },
    "6": {
      "85": 1,
      "87": 1,
      "89": 1,
      "121": 1,
      "153": 1,
      "151": 1,
      "149": 1,
      "117": 1
    },
    "7": {
      "68": 1,
      "70": 1,
      "166": 1,
      "72": 1,
      "168": 1,
      "74": 1,
      "106": 1,
      "100": 1,
      "138": 1,
      "132": 1,
      "170": 1,
      "164": 1
    },
    "8": {
      "51": 1,
      "179": 1,
      "53": 1,
      "181": 1,
      "55": 1,
      "183": 1,
      "57": 1,
      "185": 1,
      "59": 1,
      "91": 1,
      "83": 1,
      "123": 1,
      "115": 1,
      "155": 1,
      "147": 1,
      "187": 1
    },
    "9": {
      "34": 1,
      "36": 1,
      "196": 1,
      "38": 1,
      "198": 1,
      "40": 1,
      "200": 1,
      "42": 1,
      "202": 1,
      "44": 1,
      "76": 1,
      "66": 1,
      "108": 1,
      "98": 1,
      "140": 1,
      "130": 1,
      "172": 1,
      "162": 1,
      "204": 1,
      "194": 1,
      "164": 1,
      "170": 1,
      "74": 1,
      "68": 1
    }
  },
  "TileItemArray": [],
  "TotalItemNum": 9,
  "MoveVect": [
    0.0,
    0.0
  ],
  "TileTotalNum": 0,
  "TileLevelHardType": "Normal",
  "TotalCount": 93
}