{
  "AllLayerTileDict": {
    "1": {
      "38": "1",
      "40": "1",
      "198": "1",
      "200": "1",
      "33": "1",
      "45": "1",
      "193": "1",
      "205": "1"
    },
    "2": {
      "57": "1",
      "185": "1",
      "55": "1",
      "183": "1",
      "53": "1",
      "181": "1",
      "49": "1",
      "61": "1",
      "177": "1",
      "189": "1"
    },
    "3": {
      "70": "1",
      "166": "1",
      "72": "1",
      "168": "1",
      "66": "1",
      "76": "1",
      "162": "1",
      "172": "1"
    },
    "4": {
      "87": "1",
      "151": "1",
      "85": "1",
      "149": "1",
      "89": "1",
      "153": "1",
      "82": "1",
      "146": "1",
      "92": "1",
      "156": "1"
    },
    "5": {
      "99": "1",
      "131": "1",
      "101": "1",
      "133": "1",
      "107": "1",
      "139": "1",
      "103": "1",
      "135": "1",
      "105": "1",
      "137": "1",
      "65": "1",
      "77": "1",
      "97": "1",
      "109": "1",
      "129": "1",
      "141": "1",
      "161": "1",
      "173": "1"
    },
    "6": {
      "82": "1",
      "92": "1",
      "146": "1",
      "156": "1",
      "84": "1",
      "148": "1",
      "86": "1",
      "150": "1",
      "88": "1",
      "152": "1",
      "90": "1",
      "154": "1",
      "114": "1",
      "116": "1",
      "118": "1",
      "120": "1",
      "122": "1",
      "124": "1"
    },
    "7": {
      "67": "1",
      "163": "1",
      "75": "1",
      "171": "1",
      "69": "1",
      "165": "1",
      "73": "1",
      "169": "1",
      "99": "1",
      "131": "1",
      "133": "1",
      "101": "1",
      "105": "1",
      "137": "1",
      "139": "1",
      "107": "1"
    },
    "8": {
      "82": "1",
      "84": "1",
      "86": "1",
      "88": "1",
      "90": "1",
      "92": "1",
      "146": "1",
      "148": "1",
      "150": "1",
      "152": "1",
      "154": "1",
      "156": "1",
      "114": "1",
      "116": "1",
      "118": "1",
      "120": "1",
      "122": "1",
      "124": "1",
      "51": "1",
      "187": "1",
      "59": "1",
      "179": "1",
      "182": "1",
      "184": "1",
      "54": "1",
      "56": "1"
    }
  },
  "TileItemArray": [],
  "TotalItemNum": 12,
  "MoveVect": [
    0.0,
    0.0
  ],
  "TileTotalNum": 0,
  "TileLevelHardType": "Normal",
  "TotalCount": 114
}