{
  "AllLayerTileDict": {
    "1": {
      "68": 1,
      "74": 1,
      "100": 1,
      "106": 1,
      "133": 1,
      "137": 1,
      "164": 1,
      "170": 1,
      "71": 1,
      "104": 1,
      "102": 1,
      "166": 1,
      "168": 1
    },
    "2": {
      "51": 1,
      "53": 1,
      "55": 1,
      "57": 1,
      "59": 1,
      "83": 1,
      "85": 1,
      "91": 1,
      "89": 1,
      "87": 1,
      "115": 1,
      "117": 1,
      "119": 1,
      "121": 1,
      "123": 1,
      "147": 1,
      "149": 1,
      "151": 1,
      "153": 1,
      "155": 1,
      "179": 1,
      "181": 1,
      "183": 1,
      "185": 1,
      "187": 1,
      "33": 1,
      "193": 1,
      "45": 1,
      "205": 1,
      "65": 1,
      "161": 1,
      "77": 1,
      "173": 1
    },
    "3": {
      "68": 1,
      "164": 1,
      "70": 1,
      "166": 1,
      "72": 1,
      "168": 1,
      "74": 1,
      "170": 1,
      "116": 1,
      "118": 1,
      "120": 1,
      "122": 1
    },
    "4": {
      "69": 1,
      "165": 1,
      "73": 1,
      "169": 1,
      "117": 1,
      "121": 1
    },
    "5": {
      "84": 1,
      "148": 1,
      "86": 1,
      "150": 1,
      "88": 1,
      "152": 1,
      "90": 1,
      "154": 1,
      "118": 1,
      "120": 1
    },
    "6": {
      "67": 1,
      "163": 1,
      "69": 1,
      "165": 1,
      "71": 1,
      "167": 1,
      "73": 1,
      "169": 1,
      "75": 1,
      "171": 1
    }
  },
  "TileItemArray": [],
  "TotalItemNum": 9,
  "MoveVect": [
    0.0,
    0.0
  ],
  "TileTotalNum": 0,
  "TileLevelHardType": "Normal",
  "TotalCount": 84
}