{
  "AllLayerTileDict": {
    "1": {
      "17": 1,
      "29": 1,
      "49": 1,
      "61": 1,
      "81": 1,
      "93": 1,
      "113": 1,
      "125": 1,
      "145": 1,
      "157": 1,
      "177": 1,
      "189": 1,
      "209": 1,
      "221": 1,
      "35": 1,
      "43": 1,
      "195": 1,
      "203": 1,
      "67": 1,
      "75": 1,
      "99": 1,
      "107": 1,
      "131": 1,
      "139": 1,
      "163": 1,
      "171": 1,
      "85": 1,
      "89": 1,
      "117": 1,
      "121": 1,
      "149": 1,
      "153": 1,
      "103": 1,
      "135": 1
    },
    "2": {
      "34": 1,
      "44": 1,
      "66": 1,
      "76": 1,
      "98": 1,
      "108": 1,
      "130": 1,
      "140": 1,
      "162": 1,
      "172": 1,
      "194": 1,
      "204": 1,
      "84": 1,
      "90": 1,
      "116": 1,
      "122": 1,
      "148": 1,
      "154": 1,
      "120": 1,
      "118": 1,
      "24": 1,
      "216": 1,
      "26": 1,
      "218": 1,
      "20": 1,
      "212": 1,
      "22": 1,
      "214": 1
    },
    "3": {
      "51": 1,
      "59": 1,
      "83": 1,
      "91": 1,
      "115": 1,
      "123": 1,
      "147": 1,
      "155": 1,
      "179": 1,
      "187": 1,
      "69": 1,
      "73": 1,
      "101": 1,
      "105": 1,
      "133": 1,
      "137": 1,
      "165": 1,
      "169": 1,
      "119": 1,
      "41": 1,
      "201": 1,
      "37": 1,
      "197": 1,
      "39": 1,
      "199": 1
    },
    "4": {
      "68": 1,
      "74": 1,
      "100": 1,
      "106": 1,
      "132": 1,
      "138": 1,
      "164": 1,
      "170": 1,
      "86": 1,
      "88": 1,
      "118": 1,
      "120": 1,
      "150": 1,
      "152": 1,
      "54": 1,
      "182": 1,
      "56": 1,
      "184": 1
    },
    "5": {
      "85": 1,
      "117": 1,
      "149": 1,
      "89": 1,
      "121": 1,
      "153": 1,
      "103": 1,
      "135": 1,
      "71": 1,
      "167": 1
    },
    "6": {
      "88": 1,
      "152": 1,
      "86": 1,
      "150": 1,
      "118": 1,
      "120": 1
    },
    "7": {
      "103": 1,
      "135": 1
    }
  },
  "TileItemArray": [],
  "TotalItemNum": 12,
  "MoveVect": [
    0.0,
    0.0
  ],
  "TileTotalNum": 0,
  "TileLevelHardType": "Normal",
  "TotalCount": 123
}