{
  "AllLayerTileDict": {
    "1": {
      "17": 1,
      "49": 1,
      "81": 1,
      "113": 1,
      "115": 1,
      "117": 1,
      "119": 1,
      "121": 1,
      "123": 1,
      "125": 1,
      "157": 1,
      "189": 1,
      "221": 1
    },
    "2": {
      "18": 1,
      "50": 1,
      "82": 1,
      "114": 1,
      "116": 1,
      "118": 1,
      "120": 1,
      "122": 1,
      "124": 1,
      "156": 1,
      "188": 1,
      "220": 1
    },
    "3": {
      "19": 1,
      "51": 1,
      "83": 1,
      "115": 1,
      "117": 1,
      "119": 1,
      "121": 1,
      "123": 1,
      "155": 1,
      "187": 1,
      "219": 1
    },
    "4": {
      "20": 1,
      "52": 1,
      "84": 1,
      "116": 1,
      "118": 1,
      "120": 1,
      "122": 1,
      "154": 1,
      "186": 1,
      "218": 1
    },
    "5": {
      "21": 1,
      "53": 1,
      "85": 1,
      "117": 1,
      "119": 1,
      "121": 1,
      "153": 1,
      "185": 1,
      "217": 1
    },
    "6": {
      "22": 1,
      "54": 1,
      "86": 1,
      "118": 1,
      "120": 1,
      "152": 1,
      "184": 1,
      "216": 1
    },
    "7": {
      "23": 1,
      "55": 1,
      "87": 1,
      "119": 1,
      "151": 1,
      "215": 1,
      "183": 1
    },
    "8": {
      "24": 1,
      "56": 1,
      "88": 1,
      "120": 1,
      "118": 1,
      "150": 1,
      "182": 1,
      "214": 1
    },
    "9": {
      "25": 1,
      "57": 1,
      "89": 1,
      "121": 1,
      "119": 1,
      "117": 1,
      "149": 1,
      "181": 1,
      "213": 1
    },
    "10": {
      "26": 1,
      "58": 1,
      "90": 1,
      "122": 1,
      "120": 1,
      "118": 1,
      "116": 1,
      "148": 1,
      "180": 1,
      "212": 1
    },
    "11": {
      "27": 1,
      "59": 1,
      "91": 1,
      "123": 1,
      "121": 1,
      "119": 1,
      "117": 1,
      "115": 1,
      "147": 1,
      "179": 1,
      "211": 1
    }
  },
  "TileItemArray": [],
  "TotalItemNum": 10,
  "MoveVect": [
    0.0,
    0.0
  ],
  "TileTotalNum": 0,
  "TileLevelHardType": "Hard",
  "TotalCount": 108
}