{
  "AllLayerTileDict": {
    "1": {
      "17": 1,
      "49": 1,
      "81": 1,
      "119": 1,
      "21": 1,
      "19": 1,
      "123": 1,
      "89": 1,
      "153": 1,
      "187": 1,
      "217": 1,
      "93": 1,
      "157": 1,
      "221": 1,
      "183": 1,
      "213": 1,
      "149": 1,
      "85": 1
    },
    "2": {
      "34": 1,
      "66": 1,
      "98": 1,
      "36": 1,
      "38": 1,
      "106": 1,
      "170": 1,
      "204": 1,
      "140": 1,
      "72": 1,
      "200": 1,
      "136": 1,
      "76": 1,
      "102": 1,
      "166": 1,
      "196": 1,
      "132": 1,
      "68": 1
    },
    "3": {
      "51": 1,
      "83": 1,
      "115": 1,
      "53": 1,
      "55": 1,
      "89": 1,
      "93": 1,
      "123": 1,
      "153": 1,
      "157": 1,
      "187": 1,
      "217": 1,
      "221": 1,
      "119": 1,
      "183": 1,
      "85": 1,
      "149": 1,
      "213": 1
    },
    "4": {
      "68": 1,
      "100": 1,
      "132": 1,
      "70": 1,
      "72": 1,
      "108": 1,
      "138": 1,
      "172": 1,
      "202": 1,
      "168": 1,
      "104": 1,
      "198": 1,
      "134": 1
    },
    "5": {
      "85": 1,
      "117": 1,
      "149": 1,
      "87": 1,
      "89": 1,
      "123": 1,
      "153": 1,
      "183": 1,
      "187": 1,
      "157": 1,
      "217": 1,
      "213": 1,
      "93": 1
    },
    "6": {
      "102": 1,
      "134": 1,
      "166": 1,
      "104": 1,
      "106": 1,
      "108": 1,
      "140": 1,
      "170": 1,
      "200": 1,
      "198": 1
    },
    "7": {
      "119": 1,
      "151": 1,
      "183": 1,
      "121": 1,
      "123": 1,
      "185": 1,
      "155": 1
    },
    "8": {
      "136": 1,
      "168": 1,
      "200": 1,
      "138": 1,
      "140": 1
    }
  },
  "TileItemArray": [],
  "TotalItemNum": 9,
  "MoveVect": [
    0.0,
    0.0
  ],
  "TileTotalNum": 0,
  "TileLevelHardType": "Normal",
  "TotalCount": 102
}