{
  "AllLayerTileDict": {
    "1": {
      "40": 1,
      "74": 1,
      "108": 1,
      "70": 1,
      "36": 1,
      "104": 1,
      "138": 1,
      "172": 1
    },
    "2": {
      "53": 1,
      "87": 1,
      "121": 1,
      "155": 1,
      "57": 1,
      "91": 1
    },
    "3": {
      "68": 1,
      "102": 1,
      "136": 1,
      "170": 1,
      "100": 1,
      "132": 1,
      "134": 1,
      "166": 1,
      "168": 1,
      "164": 1,
      "38": 1,
      "72": 1,
      "106": 1,
      "140": 1,
      "40": 1,
      "42": 1,
      "74": 1,
      "76": 1,
      "108": 1,
      "44": 1
    },
    "4": {
      "51": 1,
      "83": 1,
      "115": 1,
      "147": 1,
      "179": 1,
      "181": 1,
      "183": 1,
      "185": 1,
      "187": 1,
      "85": 1,
      "117": 1,
      "149": 1,
      "119": 1,
      "151": 1,
      "153": 1,
      "55": 1,
      "57": 1,
      "59": 1,
      "91": 1,
      "123": 1,
      "89": 1
    },
    "5": {
      "66": 1,
      "98": 1,
      "130": 1,
      "162": 1,
      "194": 1,
      "196": 1,
      "198": 1,
      "200": 1,
      "202": 1,
      "100": 1,
      "132": 1,
      "164": 1,
      "134": 1,
      "166": 1,
      "168": 1,
      "72": 1,
      "74": 1,
      "106": 1
    },
    "6": {
      "81": 1,
      "113": 1,
      "145": 1,
      "177": 1,
      "209": 1,
      "211": 1,
      "213": 1,
      "215": 1,
      "217": 1,
      "115": 1,
      "149": 1,
      "183": 1,
      "179": 1,
      "147": 1,
      "181": 1
    },
    "7": {
      "66": 1,
      "100": 1,
      "198": 1,
      "164": 1,
      "134": 1,
      "130": 1,
      "194": 1,
      "168": 1,
      "202": 1
    },
    "8": {
      "83": 1,
      "115": 1,
      "147": 1,
      "179": 1,
      "181": 1,
      "183": 1,
      "185": 1,
      "117": 1,
      "149": 1,
      "151": 1
    },
    "9": {
      "68": 1,
      "100": 1,
      "132": 1,
      "164": 1,
      "166": 1,
      "168": 1,
      "170": 1,
      "134": 1,
      "102": 1,
      "136": 1
    }
  },
  "TileItemArray": [],
  "TotalItemNum": 12,
  "MoveVect": [
    0.5,
    -0.5
  ],
  "TileTotalNum": 0,
  "TileLevelHardType": "Normal",
  "TotalCount": 117
}