{
  "AllLayerTileDict": {
    "1": {
      "209": 1,
      "211": 1,
      "213": 1,
      "215": 1,
      "217": 1,
      "219": 1,
      "221": 1,
      "49": 1,
      "81": 1,
      "113": 1,
      "145": 1,
      "147": 1,
      "149": 1,
      "151": 1,
      "153": 1,
      "83": 1,
      "115": 1,
      "117": 1,
      "155": 1,
      "157": 1,
      "125": 1,
      "93": 1,
      "61": 1,
      "123": 1,
      "91": 1,
      "121": 1,
      "23": -2,
      "21": -2,
      "25": -2
    },
    "2": {
      "66": 1,
      "98": 1,
      "130": 1,
      "162": 1,
      "164": 1,
      "166": 1,
      "168": 1,
      "170": 1,
      "172": 1,
      "140": 1,
      "108": 1,
      "76": 1,
      "100": 1,
      "132": 1,
      "134": 1,
      "136": 1,
      "138": 1,
      "106": 1,
      "194": 1,
      "196": 1,
      "198": 1,
      "200": 1,
      "202": 1,
      "204": 1,
      "23": -2,
      "21": -2,
      "25": -2
    },
    "3": {
      "83": 1,
      "115": 1,
      "147": 1,
      "149": 1,
      "151": 1,
      "153": 1,
      "155": 1,
      "123": 1,
      "91": 1,
      "117": 1,
      "121": 1,
      "209": 1,
      "211": 1,
      "213": 1,
      "215": 1,
      "217": 1,
      "219": 1,
      "221": 1,
      "23": -2,
      "21": -2,
      "25": -2
    },
    "4": {
      "100": 1,
      "132": 1,
      "164": 1,
      "166": 1,
      "168": 1,
      "170": 1,
      "138": 1,
      "106": 1,
      "134": 1,
      "136": 1,
      "194": 1,
      "196": 1,
      "198": 1,
      "200": 1,
      "202": 1,
      "204": 1,
      "23": -2,
      "21": -2,
      "25": -2
    },
    "5": {
      "209": 1,
      "211": 1,
      "213": 1,
      "215": 1,
      "217": 1,
      "219": 1,
      "221": 1,
      "23": -2,
      "21": -2,
      "25": -2
    },
    "6": {
      "194": 1,
      "196": 1,
      "198": 1,
      "200": 1,
      "202": 1,
      "204": 1,
      "21": -2,
      "25": -2,
      "23": -2
    },
    "7": {
      "209": 1,
      "211": 1,
      "213": 1,
      "215": 1,
      "217": 1,
      "219": 1,
      "221": 1,
      "23": -2
    },
    "8": {
      "23": -2
    },
    "9": {
      "23": -2
    },
    "10": {
      "23": -2
    }
  },
  "TileItemArray": [],
  "TotalItemNum": 9,
  "MoveVect": [
    0.0,
    0.0
  ],
  "TileTotalNum": 0,
  "TileLevelHardType": "Normal",
  "TotalCount": 126
}