{
  "AllLayerTileDict": {
    "1": {
      "21": 1,
      "25": 1,
      "53": 1,
      "57": 1,
      "85": 1,
      "89": 1,
      "117": 1,
      "121": 1,
      "149": 1,
      "153": 1,
      "181": 1,
      "185": 1,
      "213": 1,
      "217": 1
    },
    "2": {
      "36": 1,
      "42": 1,
      "68": 1,
      "74": 1,
      "100": 1,
      "106": 1,
      "132": 1,
      "138": 1,
      "164": 1,
      "170": 1,
      "196": 1,
      "202": 1
    },
    "3": {
      "51": 1,
      "59": 1,
      "83": 1,
      "91": 1,
      "115": 1,
      "123": 1,
      "147": 1,
      "155": 1,
      "179": 1,
      "187": 1
    },
    "4": {
      "66": 1,
      "76": 1,
      "98": 1,
      "108": 1,
      "130": 1,
      "140": 1,
      "162": 1,
      "172": 1
    },
    "5": {
      "81": 1,
      "93": 1,
      "145": 1,
      "157": 1,
      "115": 1,
      "123": 1
    },
    "6": {
      "66": 1,
      "76": 1,
      "100": 1,
      "106": 1,
      "132": 1,
      "138": 1,
      "162": 1,
      "172": 1
    },
    "7": {
      "51": 1,
      "59": 1,
      "85": 1,
      "89": 1,
      "149": 1,
      "153": 1,
      "117": 1,
      "121": 1,
      "179": 1,
      "187": 1
    },
    "8": {
      "36": 1,
      "42": 1,
      "70": 1,
      "72": 1,
      "102": 1,
      "104": 1,
      "134": 1,
      "136": 1,
      "166": 1,
      "168": 1,
      "196": 1,
      "202": 1
    },
    "9": {
      "87": 1,
      "119": 1,
      "151": 1,
      "53": 1,
      "181": 1,
      "57": 1,
      "185": 1
    },
    "10": {
      "70": 1,
      "72": 1,
      "166": 1,
      "168": 1,
      "104": 1,
      "136": 1,
      "102": 1,
      "134": 1
    },
    "11": {
      "87": 1,
      "119": 1,
      "151": 1
    },
    "12": {
      "102": 1,
      "134": 1,
      "104": 1,
      "136": 1
    }
  },
  "TileItemArray": [],
  "TotalItemNum": 9,
  "MoveVect": [
    0.0,
    0.0
  ],
  "TileTotalNum": 0,
  "TileLevelHardType": "Normal",
  "TotalCount": 102
}